date,geography,geography code,Tenure of household: Total: All households,Tenure of household: Owned,Tenure of household: Owned: Owns outright,Tenure of household: Owned: Owns with a mortgage or loan,Tenure of household: Shared ownership,Tenure of household: Shared ownership: Shared ownership,Tenure of household: Social rented,Tenure of household: Social rented: Rents from council or Local Authority,Tenure of household: Social rented: Other social rented,Tenure of household: Private rented,Tenure of household: Private rented: Private landlord or letting agency,Tenure of household: Private rented: Other private rented,Tenure of household: Lives rent free
2021,City of London 001,E02000001,4914,1794,1114,680,12,12,730,449,281,2373,2064,309,5
2021,Barking and Dagenham 001,E02000002,2870,1236,507,729,10,10,1199,921,278,417,380,37,8
2021,Barking and Dagenham 002,E02000003,3930,2186,942,1244,24,24,522,409,113,1197,1110,87,1
2021,Barking and Dagenham 003,E02000004,2309,1543,649,894,16,16,373,261,112,376,337,39,1
2021,Barking and Dagenham 004,E02000005,3628,1882,582,1300,47,47,912,693,219,779,717,62,8
2021,Barking and Dagenham 006,E02000007,3676,1453,474,979,60,60,1552,1421,131,602,555,47,9
2021,Barking and Dagenham 007,E02000008,4625,2024,683,1341,45,45,1642,1443,199,903,838,65,11
2021,Barking and Dagenham 008,E02000009,4254,1546,472,1074,79,79,1470,934,536,1154,1047,107,5
2021,Barking and Dagenham 009,E02000010,3329,1445,484,961,49,49,1119,904,215,712,646,66,4
2021,Barking and Dagenham 010,E02000011,2353,1309,584,725,14,14,351,239,112,679,607,72,0
2021,Barking and Dagenham 011,E02000012,3288,2216,861,1355,10,10,402,324,78,660,594,66,0
2021,Barking and Dagenham 012,E02000013,3255,1328,473,855,21,21,1206,1078,128,689,623,66,11
2021,Barking and Dagenham 013,E02000014,3388,1407,502,905,18,18,1207,1012,195,751,682,69,5
2021,Barking and Dagenham 014,E02000015,3032,936,375,561,67,67,1432,1066,366,593,537,56,4
2021,Barking and Dagenham 015,E02000016,3810,726,216,510,178,178,1313,838,475,1582,1500,82,11
2021,Barking and Dagenham 016,E02000017,2767,1286,579,707,12,12,296,177,119,1171,1093,78,2
2021,Barking and Dagenham 017,E02000018,3232,1279,420,859,19,19,1221,983,238,706,643,63,7
2021,Barking and Dagenham 018,E02000019,3208,1336,405,931,75,75,1142,923,219,652,600,52,3
2021,Barking and Dagenham 019,E02000020,4676,1876,530,1346,178,178,1460,925,535,1135,1042,93,27
2021,Barking and Dagenham 020,E02000021,2930,1387,550,837,29,29,610,437,173,896,832,64,8
2021,Barking and Dagenham 021,E02000022,2797,483,111,372,202,202,1375,1118,257,729,669,60,8
2021,Barking and Dagenham 022,E02000023,2663,797,194,603,48,48,1283,1087,196,530,482,48,5
2021,Barnet 001,E02000024,4475,3023,1640,1383,37,37,337,107,230,1077,975,102,1
2021,Barnet 002,E02000025,3745,2140,1061,1079,33,33,545,247,298,1025,956,69,2
2021,Barnet 003,E02000026,2511,1796,961,835,21,21,145,88,57,549,493,56,0
2021,Barnet 004,E02000027,3685,1970,908,1062,74,74,1067,662,405,570,534,36,4
2021,Barnet 005,E02000028,2694,1723,871,852,9,9,146,67,79,811,754,57,5
2021,Barnet 006,E02000029,3706,2099,930,1169,12,12,342,204,138,1251,1162,89,2
2021,Barnet 007,E02000030,3519,2635,1417,1218,9,9,395,329,66,480,393,87,0
2021,Barnet 008,E02000031,3327,2205,1078,1127,104,104,200,72,128,817,752,65,1
2021,Barnet 009,E02000032,2744,2249,1154,1095,11,11,95,15,80,389,350,39,0
2021,Barnet 010,E02000033,3494,2190,1087,1103,66,66,467,173,294,771,708,63,0
2021,Barnet 011,E02000034,3588,2138,1044,1094,59,59,338,186,152,1052,978,74,1
2021,Barnet 012,E02000035,3530,1781,971,810,20,20,357,176,181,1370,1272,98,2
2021,Barnet 013,E02000036,3946,2376,1128,1248,40,40,499,242,257,1030,944,86,1
2021,Barnet 014,E02000037,3717,2336,1133,1203,110,110,511,74,437,757,664,93,3
2021,Barnet 015,E02000038,4005,2375,1112,1263,13,13,402,239,163,1211,1102,109,4
2021,Barnet 016,E02000039,2671,1800,850,950,4,4,114,81,33,753,698,55,0
2021,Barnet 017,E02000040,3510,2157,936,1221,70,70,622,228,394,659,578,81,2
2021,Barnet 018,E02000041,3327,1753,937,816,20,20,363,228,135,1190,1105,85,1
2021,Barnet 019,E02000042,4717,2228,1186,1042,14,14,321,176,145,2149,2041,108,5
2021,Barnet 020,E02000043,2666,1867,985,882,9,9,59,29,30,730,696,34,1
2021,Barnet 021,E02000044,3070,1346,576,770,48,48,845,588,257,828,757,71,3
2021,Barnet 022,E02000045,4202,1985,905,1080,34,34,892,589,303,1281,1177,104,10
2021,Barnet 023,E02000046,2879,1328,685,643,16,16,109,24,85,1426,1360,66,0
2021,Barnet 024,E02000047,4210,1518,696,822,52,52,1307,930,377,1323,1230,93,10
2021,Barnet 025,E02000048,3950,2528,1242,1286,10,10,209,58,151,1203,1101,102,0
2021,Barnet 026,E02000049,3802,1021,278,743,144,144,1924,918,1006,698,616,82,15
2021,Barnet 027,E02000050,4034,1915,938,977,46,46,1012,322,690,1047,976,71,14
2021,Barnet 028,E02000051,3792,2085,1234,851,8,8,204,140,64,1494,1392,102,1
2021,Barnet 029,E02000052,4192,2126,1069,1057,14,14,676,419,257,1370,1290,80,6
2021,Barnet 031,E02000054,2971,1375,664,711,24,24,185,33,152,1387,1308,79,0
2021,Barnet 032,E02000055,4503,1709,915,794,14,14,544,366,178,2234,2088,146,2
2021,Barnet 033,E02000056,3441,2344,1289,1055,13,13,208,51,157,876,769,107,0
2021,Barnet 034,E02000057,2705,1235,624,611,5,5,212,127,85,1252,1148,104,1
2021,Barnet 035,E02000058,4097,2302,1349,953,10,10,239,85,154,1543,1446,97,3
2021,Barnet 036,E02000059,4434,1925,875,1050,39,39,720,390,330,1746,1647,99,4
2021,Barnet 037,E02000060,3696,1665,911,754,17,17,311,57,254,1702,1577,125,1
2021,Barnet 038,E02000061,3573,1588,908,680,14,14,130,67,63,1837,1724,113,4
2021,Barnet 039,E02000062,2614,796,416,380,30,30,716,390,326,1065,1008,57,7
2021,Barnet 040,E02000063,2834,1257,700,557,23,23,223,100,123,1329,1241,88,2
2021,Barnet 041,E02000064,2762,1114,527,587,27,27,685,506,179,930,867,63,6
2021,Bexley 001,E02000065,2776,1182,375,807,15,15,802,209,593,759,709,50,18
2021,Bexley 002,E02000066,3547,1105,536,569,11,11,1739,273,1466,680,611,69,12
2021,Bexley 003,E02000067,3983,1978,791,1187,24,24,804,179,625,1172,1085,87,5
2021,Bexley 004,E02000068,3194,1321,512,809,160,160,942,215,727,768,701,67,3
2021,Bexley 005,E02000069,2811,1834,819,1015,83,83,405,78,327,487,420,67,2
2021,Bexley 006,E02000070,3140,2425,1312,1113,40,40,253,46,207,422,361,61,0
2021,Bexley 007,E02000071,2835,2000,973,1027,14,14,409,88,321,411,357,54,1
2021,Bexley 008,E02000072,4688,2190,646,1544,109,109,1613,307,1306,770,721,49,6
2021,Bexley 009,E02000073,3955,3441,1740,1701,19,19,163,26,137,332,273,59,0
2021,Bexley 010,E02000074,3502,1678,685,993,136,136,1290,174,1116,394,359,35,4
2021,Bexley 011,E02000075,3149,2664,1526,1138,7,7,180,22,158,298,264,34,0
2021,Bexley 013,E02000077,2938,2236,1043,1193,16,16,305,46,259,379,336,43,2
2021,Bexley 014,E02000078,3022,2526,1198,1328,21,21,162,44,118,312,276,36,1
2021,Bexley 015,E02000079,3586,2560,1304,1256,80,80,205,42,163,739,671,68,2
2021,Bexley 016,E02000080,3815,2915,1454,1461,53,53,241,34,207,606,543,63,0
2021,Bexley 017,E02000081,3279,2384,1218,1166,21,21,465,79,386,409,364,45,0
2021,Bexley 018,E02000082,3442,2962,1382,1580,16,16,80,17,63,384,325,59,0
2021,Bexley 019,E02000083,4447,2835,1126,1709,79,79,801,164,637,730,648,82,2
2021,Bexley 020,E02000084,4199,3525,1719,1806,22,22,181,26,155,470,407,63,1
2021,Bexley 021,E02000085,3070,2529,1168,1361,18,18,123,23,100,399,360,39,1
2021,Bexley 022,E02000086,2788,2415,1227,1188,14,14,45,12,33,314,277,37,0
2021,Bexley 023,E02000087,3319,2648,1396,1252,35,35,166,18,148,468,426,42,2
2021,Bexley 024,E02000088,2981,2587,1272,1315,12,12,115,20,95,267,233,34,0
2021,Bexley 025,E02000089,2905,2507,1216,1291,9,9,156,15,141,231,195,36,2
2021,Bexley 026,E02000090,4193,2703,1342,1361,77,77,419,46,373,994,913,81,0
2021,Bexley 027,E02000091,4447,2979,1648,1331,73,73,655,67,588,740,670,70,0
2021,Bexley 028,E02000092,2714,1462,697,765,71,71,873,148,725,308,274,34,0
2021,Brent 001,E02000093,3741,2079,1177,902,106,106,387,67,320,1167,1061,106,2
2021,Brent 002,E02000094,3468,1791,833,958,122,122,522,102,420,1029,926,103,4
2021,Brent 003,E02000095,3183,1732,1052,680,22,22,361,181,180,1065,982,83,3
2021,Brent 004,E02000096,2498,1772,1035,737,12,12,108,53,55,605,543,62,1
2021,Brent 005,E02000097,3038,1722,931,791,16,16,310,216,94,989,920,69,1
2021,Brent 006,E02000098,2875,1325,703,622,28,28,643,244,399,877,805,72,2
2021,Brent 007,E02000099,2917,1300,722,578,30,30,400,114,286,1185,1105,80,2
2021,Brent 008,E02000100,2566,1693,975,718,21,21,267,42,225,585,537,48,0
2021,Brent 009,E02000101,3387,1217,650,567,42,42,1039,322,717,1083,1003,80,6
2021,Brent 010,E02000102,2681,977,621,356,86,86,607,188,419,1007,947,60,4
2021,Brent 011,E02000103,3462,1348,775,573,74,74,891,428,463,1140,1079,61,9
2021,Brent 012,E02000104,2415,1216,674,542,62,62,370,104,266,765,684,81,2
2021,Brent 013,E02000105,3109,1359,699,660,39,39,419,153,266,1289,1194,95,3
2021,Brent 014,E02000106,3586,1212,737,475,31,31,666,283,383,1673,1570,103,4
2021,Brent 015,E02000107,4362,1433,743,690,57,57,811,206,605,2052,1925,127,9
2021,Brent 016,E02000108,2275,1153,555,598,65,65,299,75,224,756,709,47,2
2021,Brent 018,E02000110,3094,1348,743,605,30,30,657,196,461,1055,988,67,4
2021,Brent 019,E02000111,3186,1303,699,604,33,33,450,176,274,1398,1283,115,2
2021,Brent 020,E02000112,3496,1389,857,532,85,85,424,132,292,1596,1482,114,2
2021,Brent 021,E02000113,3289,645,348,297,34,34,1916,1270,646,683,626,57,11
2021,Brent 022,E02000114,3705,1091,570,521,55,55,753,258,495,1800,1670,130,6
2021,Brent 023,E02000115,3876,1151,542,609,39,39,1018,574,444,1661,1573,88,7
2021,Brent 024,E02000116,3237,674,340,334,103,103,1101,261,840,1346,1285,61,13
2021,Brent 025,E02000117,4759,989,452,537,156,156,2222,473,1749,1385,1298,87,7
2021,Brent 026,E02000118,3155,1455,710,745,34,34,550,273,277,1115,1005,110,1
2021,Brent 027,E02000119,3952,634,197,437,211,211,2123,712,1411,969,909,60,15
2021,Brent 028,E02000120,4243,1316,580,736,30,30,1011,363,648,1881,1795,86,5
2021,Brent 029,E02000121,3627,1467,784,683,192,192,507,113,394,1459,1295,164,2
2021,Brent 030,E02000122,3160,1665,818,847,33,33,570,270,300,887,813,74,5
2021,Brent 031,E02000123,5538,1230,560,670,84,84,1921,533,1388,2290,2179,111,13
2021,Brent 032,E02000124,4160,1785,827,958,34,34,847,412,435,1493,1396,97,1
2021,Brent 033,E02000125,3940,1915,938,977,26,26,815,213,602,1178,1096,82,6
2021,Brent 034,E02000126,3405,529,188,341,83,83,2114,1264,850,672,617,55,7
2021,Bromley 001,E02000127,3789,1854,733,1121,38,38,1237,174,1063,656,565,91,4
2021,Bromley 002,E02000128,3063,2213,1007,1206,13,13,361,24,337,476,417,59,0
2021,Bromley 004,E02000130,3662,2159,845,1314,44,44,641,65,576,816,755,61,2
2021,Bromley 005,E02000131,5067,2081,535,1546,67,67,1157,119,1038,1759,1671,88,3
2021,Bromley 006,E02000132,4942,2549,1168,1381,103,103,649,53,596,1640,1521,119,1
2021,Bromley 007,E02000133,4328,3493,1759,1734,51,51,150,7,143,634,575,59,0
2021,Bromley 008,E02000134,5300,2835,1183,1652,16,16,773,71,702,1669,1546,123,7
2021,Bromley 009,E02000135,4439,1171,358,813,92,92,2062,311,1751,1108,1028,80,6
2021,Bromley 010,E02000136,2294,1646,875,771,10,10,434,57,377,203,172,31,1
2021,Bromley 011,E02000137,3676,2520,1232,1288,16,16,243,20,223,896,824,72,1
2021,Bromley 012,E02000138,4139,2748,1574,1174,17,17,164,11,153,1209,1103,106,1
2021,Bromley 013,E02000139,3310,2149,802,1347,36,36,449,39,410,675,617,58,1
2021,Bromley 014,E02000140,3337,1552,619,933,53,53,1397,220,1177,335,301,34,0
2021,Bromley 015,E02000141,3092,1945,770,1175,28,28,418,61,357,701,652,49,0
2021,Bromley 016,E02000142,3454,2572,1172,1400,13,13,189,14,175,680,622,58,0
2021,Bromley 018,E02000144,4312,2594,1176,1418,64,64,241,30,211,1411,1313,98,2
2021,Bromley 019,E02000145,3514,1758,747,1011,79,79,1163,206,957,514,453,61,0
2021,Bromley 020,E02000146,4039,2723,1085,1638,60,60,332,26,306,924,851,73,0
2021,Bromley 021,E02000147,3166,2564,1363,1201,2,2,133,14,119,466,419,47,1
2021,Bromley 022,E02000148,2699,2200,1169,1031,8,8,196,12,184,295,267,28,0
2021,Bromley 023,E02000149,3284,2138,995,1143,37,37,642,70,572,465,419,46,2
2021,Bromley 024,E02000150,3115,2488,1132,1356,17,17,286,18,268,324,277,47,0
2021,Bromley 025,E02000151,2972,2664,1401,1263,4,4,66,10,56,237,210,27,1
2021,Bromley 026,E02000152,3096,1881,762,1119,34,34,843,108,735,338,303,35,0
2021,Bromley 027,E02000153,2895,2634,1242,1392,4,4,113,10,103,144,119,25,0
2021,Bromley 028,E02000154,3573,2561,1312,1249,27,27,281,31,250,704,632,72,0
2021,Bromley 029,E02000155,3040,2452,1403,1049,26,26,254,36,218,307,258,49,1
2021,Bromley 030,E02000156,4862,4018,2213,1805,22,22,258,16,242,563,492,71,1
2021,Bromley 031,E02000157,3280,2909,1609,1300,4,4,64,7,57,303,268,35,0
2021,Bromley 032,E02000158,3033,2125,1191,934,28,28,638,79,559,238,212,26,4
2021,Bromley 033,E02000159,2821,2438,1318,1120,10,10,78,8,70,295,245,50,0
2021,Bromley 034,E02000160,3042,2572,1350,1222,20,20,104,6,98,343,303,40,3
2021,Bromley 035,E02000161,3345,2914,1540,1374,3,3,82,13,69,346,303,43,0
2021,Bromley 036,E02000162,2965,2159,1192,967,10,10,499,20,479,297,249,48,0
2021,Bromley 037,E02000163,3068,2579,1371,1208,14,14,196,19,177,278,237,41,1
2021,Bromley 039,E02000165,2741,2363,1057,1306,17,17,125,15,110,234,198,36,2
2021,Camden 001,E02000166,3395,1506,867,639,29,29,1217,1061,156,626,544,82,17
2021,Camden 002,E02000167,3375,1776,1143,633,14,14,317,205,112,1258,1133,125,10
2021,Camden 003,E02000168,3494,1415,713,702,19,19,983,543,440,1069,981,88,8
2021,Camden 004,E02000169,3027,1527,890,637,27,27,267,151,116,1203,1088,115,3
2021,Camden 005,E02000170,3462,1530,715,815,24,24,410,202,208,1497,1416,81,1
2021,Camden 006,E02000171,3330,1392,736,656,35,35,895,598,297,1005,908,97,3
2021,Camden 007,E02000172,4036,899,433,466,37,37,2237,1803,434,842,786,56,21
2021,Camden 008,E02000173,3503,1245,728,517,9,9,585,319,266,1659,1531,128,5
2021,Camden 009,E02000174,3551,1025,484,541,9,9,1507,1195,312,1003,926,77,7
2021,Camden 010,E02000175,4309,1261,592,669,35,35,909,429,480,2091,1983,108,13
2021,Camden 011,E02000176,3000,1156,653,503,14,14,307,134,173,1522,1429,93,1
2021,Camden 012,E02000177,3654,910,438,472,10,10,1703,1584,119,1020,921,99,11
2021,Camden 013,E02000178,4166,977,365,612,43,43,1334,866,468,1798,1720,78,14
2021,Camden 014,E02000179,2549,911,531,380,5,5,748,648,100,877,808,69,8
2021,Camden 015,E02000180,3514,938,461,477,34,34,1364,969,395,1169,1068,101,9
2021,Camden 016,E02000181,3749,1315,650,665,19,19,657,363,294,1754,1661,93,4
2021,Camden 017,E02000182,3083,986,576,410,34,34,643,460,183,1414,1284,130,6
2021,Camden 018,E02000183,3616,1248,703,545,15,15,1176,484,692,1169,1069,100,8
2021,Camden 019,E02000184,3633,670,333,337,85,85,1599,1207,392,1264,1158,106,15
2021,Camden 020,E02000185,4071,747,334,413,43,43,1844,1386,458,1415,1318,97,22
2021,Camden 021,E02000186,2940,755,435,320,18,18,885,466,419,1276,1154,122,6
2021,Camden 022,E02000187,3817,458,261,197,52,52,2454,1554,900,837,770,67,16
2021,Camden 023,E02000188,2719,321,188,133,13,13,1819,1245,574,550,515,35,16
2021,Camden 026,E02000191,2107,507,320,187,18,18,511,305,206,1065,969,96,6
2021,Camden 027,E02000192,3090,559,297,262,9,9,1568,1032,536,939,849,90,15
2021,Camden 028,E02000193,3100,727,475,252,38,38,1064,480,584,1262,1105,157,9
2021,Croydon 001,E02000194,4203,2041,786,1255,49,49,956,510,446,1151,1063,88,6
2021,Croydon 002,E02000195,3493,2488,1147,1341,55,55,271,180,91,678,562,116,1
2021,Croydon 003,E02000196,2813,1557,785,772,24,24,540,394,146,682,623,59,10
2021,Croydon 004,E02000197,3317,1724,806,918,43,43,530,379,151,1018,932,86,2
2021,Croydon 005,E02000198,3501,1655,638,1017,59,59,719,307,412,1057,976,81,11
2021,Croydon 006,E02000199,3207,1970,830,1140,25,25,352,128,224,854,766,88,6
2021,Croydon 007,E02000200,4000,2024,692,1332,31,31,530,185,345,1409,1327,82,6
2021,Croydon 008,E02000201,3820,1418,527,891,22,22,1131,550,581,1239,1180,59,10
2021,Croydon 009,E02000202,3037,1851,866,985,17,17,229,107,122,938,856,82,2
2021,Croydon 010,E02000203,3117,1258,530,728,77,77,659,351,308,1115,1009,106,8
2021,Croydon 011,E02000204,3227,1780,923,857,37,37,378,199,179,1025,926,99,7
2021,Croydon 013,E02000206,4466,1678,597,1081,91,91,1120,500,620,1564,1464,100,13
2021,Croydon 014,E02000207,3560,1643,612,1031,96,96,961,327,634,855,795,60,5
2021,Croydon 015,E02000208,4098,1202,421,781,156,156,1269,594,675,1445,1334,111,26
2021,Croydon 016,E02000209,3063,1566,591,975,22,22,582,182,400,888,810,78,5
2021,Croydon 017,E02000210,3446,2051,811,1240,62,62,439,165,274,892,812,80,2
2021,Croydon 018,E02000211,3291,2737,1367,1370,8,8,203,30,173,342,293,49,1
2021,Croydon 019,E02000212,3262,1296,516,780,70,70,851,472,379,1029,955,74,16
2021,Croydon 020,E02000213,5388,1233,463,770,106,106,1451,773,678,2591,2495,96,7
2021,Croydon 021,E02000214,2325,1793,924,869,22,22,127,21,106,383,346,37,0
2021,Croydon 022,E02000215,5255,1953,814,1139,62,62,892,434,458,2329,2219,110,19
2021,Croydon 023,E02000216,2942,1478,775,703,9,9,341,33,308,1113,1049,64,1
2021,Croydon 024,E02000217,5021,2024,677,1347,115,115,1093,463,630,1777,1666,111,12
2021,Croydon 025,E02000218,2351,1368,716,652,6,6,759,614,145,208,185,23,10
2021,Croydon 026,E02000219,2983,2567,1487,1080,8,8,87,33,54,320,268,52,1
2021,Croydon 028,E02000221,3988,1798,705,1093,114,114,1235,775,460,830,752,78,11
2021,Croydon 029,E02000222,3637,2127,862,1265,43,43,363,103,260,1102,1034,68,2
2021,Croydon 030,E02000223,2788,733,316,417,6,6,1780,1531,249,257,238,19,12
2021,Croydon 031,E02000224,3271,1897,721,1176,49,49,301,118,183,1016,948,68,8
2021,Croydon 032,E02000225,2658,1383,662,721,25,25,994,671,323,246,212,34,10
2021,Croydon 033,E02000226,2781,2440,1315,1125,15,15,63,45,18,262,226,36,1
2021,Croydon 034,E02000227,4837,3381,1614,1767,30,30,630,425,205,787,714,73,9
2021,Croydon 035,E02000228,3008,2643,1455,1188,5,5,70,45,25,289,256,33,1
2021,Croydon 036,E02000229,2236,920,407,513,19,19,1044,788,256,247,222,25,6
2021,Croydon 037,E02000230,4231,2775,1308,1467,100,100,413,156,257,937,868,69,6
2021,Croydon 038,E02000231,2752,2302,1077,1225,6,6,79,29,50,365,326,39,0
2021,Croydon 039,E02000232,2367,1954,1048,906,23,23,236,196,40,154,126,28,0
2021,Croydon 040,E02000233,2395,1687,640,1047,40,40,327,201,126,337,306,31,4
2021,Croydon 041,E02000234,3720,2349,1000,1349,182,182,580,202,378,606,561,45,3
2021,Croydon 042,E02000235,2656,2101,970,1131,33,33,259,111,148,263,228,35,0
2021,Croydon 043,E02000236,3308,2776,1070,1706,22,22,245,110,135,264,238,26,1
2021,Croydon 044,E02000237,3034,2468,1309,1159,6,6,361,333,28,194,165,29,5
2021,Ealing 001,E02000238,3735,1855,814,1041,38,38,641,264,377,1198,1113,85,3
2021,Ealing 002,E02000239,2929,1941,1030,911,22,22,88,24,64,878,797,81,0
2021,Ealing 003,E02000240,3897,1713,720,993,69,69,1212,787,425,870,808,62,33
2021,Ealing 004,E02000241,2600,1492,694,798,11,11,236,136,100,856,788,68,5
2021,Ealing 005,E02000242,2231,1355,701,654,17,17,104,74,30,754,675,79,1
2021,Ealing 006,E02000243,3126,1596,836,760,33,33,512,286,226,969,902,67,16
2021,Ealing 007,E02000244,2939,1511,782,729,33,33,220,99,121,1173,1085,88,2
2021,Ealing 008,E02000245,3353,1062,399,663,178,178,1276,671,605,829,771,58,8
2021,Ealing 009,E02000246,3073,1414,557,857,14,14,941,767,174,685,634,51,19
2021,Ealing 010,E02000247,3892,1726,712,1014,134,134,958,504,454,1057,994,63,17
2021,Ealing 011,E02000248,2988,1340,745,595,59,59,147,76,71,1440,1371,69,2
2021,Ealing 012,E02000249,2914,1445,747,698,74,74,451,287,164,930,859,71,14
2021,Ealing 013,E02000250,2544,1772,949,823,32,32,124,72,52,614,574,40,2
2021,Ealing 014,E02000251,2542,1633,861,772,25,25,151,32,119,731,640,91,2
2021,Ealing 015,E02000252,4410,1218,682,536,162,162,951,260,691,2071,1918,153,8
2021,Ealing 016,E02000253,3841,1512,689,823,43,43,1566,1330,236,691,631,60,29
2021,Ealing 017,E02000254,2608,1559,892,667,9,9,187,132,55,851,716,135,2
2021,Ealing 018,E02000255,3792,1938,971,967,28,28,723,402,321,1097,1037,60,6
2021,Ealing 019,E02000256,4028,1696,854,842,65,65,412,99,313,1852,1759,93,3
2021,Ealing 021,E02000258,2603,1088,550,538,16,16,440,123,317,1055,1004,51,4
2021,Ealing 022,E02000259,2398,1412,701,711,41,41,247,86,161,694,632,62,4
2021,Ealing 023,E02000260,2754,1266,802,464,19,19,381,185,196,1082,977,105,6
2021,Ealing 024,E02000261,4977,1608,780,828,243,243,1114,571,543,1994,1812,182,18
2021,Ealing 025,E02000262,3946,1384,592,792,72,72,919,300,619,1563,1486,77,8
2021,Ealing 026,E02000263,3646,1611,997,614,80,80,637,209,428,1310,1163,147,8
2021,Ealing 027,E02000264,3543,1590,815,775,32,32,366,87,279,1553,1459,94,2
2021,Ealing 028,E02000265,4733,1869,829,1040,115,115,1106,251,855,1628,1516,112,15
2021,Ealing 029,E02000266,4298,1454,622,832,241,241,1723,879,844,859,755,104,21
2021,Ealing 030,E02000267,3219,1651,736,915,116,116,444,152,292,1005,935,70,3
2021,Ealing 031,E02000268,3864,1910,944,966,34,34,639,467,172,1270,1178,92,11
2021,Ealing 032,E02000269,3307,1980,1014,966,11,11,191,106,85,1125,1057,68,0
2021,Ealing 033,E02000270,4116,1353,387,966,268,268,1381,520,861,1104,1026,78,10
2021,Ealing 034,E02000271,2977,1823,869,954,17,17,188,74,114,948,882,66,1
2021,Ealing 035,E02000272,2539,1820,970,850,19,19,163,100,63,534,482,52,3
2021,Ealing 038,E02000275,2348,981,526,455,19,19,481,203,278,855,756,99,12
2021,Ealing 039,E02000276,2724,1479,645,834,15,15,298,147,151,930,874,56,2
2021,Enfield 001,E02000277,2628,1428,727,701,19,19,370,203,167,806,743,63,5
2021,Enfield 002,E02000278,3341,1271,636,635,40,40,1125,784,341,893,795,98,12
2021,Enfield 003,E02000279,4419,1667,614,1053,202,202,1120,526,594,1420,1343,77,10
2021,Enfield 004,E02000280,3410,2135,1037,1098,34,34,679,549,130,553,479,74,9
2021,Enfield 005,E02000281,3550,1772,756,1016,69,69,774,491,283,923,867,56,12
2021,Enfield 006,E02000282,3468,1095,475,620,23,23,1221,918,303,1106,1064,42,23
2021,Enfield 007,E02000283,2800,1508,701,807,16,16,476,309,167,797,740,57,3
2021,Enfield 008,E02000284,3618,2229,1064,1165,34,34,415,294,121,935,853,82,5
2021,Enfield 009,E02000285,2460,2052,1084,968,6,6,84,46,38,318,282,36,0
2021,Enfield 010,E02000286,4002,2632,1408,1224,12,12,263,124,139,1092,999,93,3
2021,Enfield 011,E02000287,2870,2030,1075,955,50,50,248,159,89,537,472,65,5
2021,Enfield 012,E02000288,4053,1654,736,918,70,70,954,597,357,1360,1265,95,15
2021,Enfield 013,E02000289,2427,1983,1065,918,8,8,161,88,73,275,240,35,0
2021,Enfield 014,E02000290,2517,832,334,498,47,47,808,557,251,811,757,54,19
2021,Enfield 015,E02000291,4329,2066,992,1074,23,23,618,450,168,1616,1531,85,6
2021,Enfield 016,E02000292,3569,2309,1031,1278,15,15,290,223,67,952,869,83,3
2021,Enfield 017,E02000293,2491,1972,1122,850,7,7,86,46,40,426,381,45,0
2021,Enfield 018,E02000294,3086,1555,807,748,32,32,572,369,203,919,861,58,8
2021,Enfield 019,E02000295,3350,2124,1114,1010,48,48,310,128,182,868,803,65,0
2021,Enfield 020,E02000296,4040,1926,1042,884,29,29,388,309,79,1694,1585,109,3
2021,Enfield 021,E02000297,3475,2789,1535,1254,10,10,83,43,40,591,534,57,2
2021,Enfield 022,E02000298,3056,2331,1158,1173,5,5,107,77,30,612,552,60,1
2021,Enfield 023,E02000299,3317,1325,704,621,56,56,531,279,252,1398,1295,103,7
2021,Enfield 024,E02000300,2998,1403,729,674,9,9,370,195,175,1208,1129,79,8
2021,Enfield 025,E02000301,3726,1190,612,578,44,44,1228,662,566,1249,1187,62,15
2021,Enfield 026,E02000302,3114,2054,1064,990,8,8,354,234,120,696,621,75,2
2021,Enfield 027,E02000303,2976,1032,502,530,17,17,945,627,318,965,900,65,17
2021,Enfield 028,E02000304,2911,2238,1202,1036,14,14,72,51,21,586,513,73,1
2021,Enfield 029,E02000305,3452,2032,948,1084,15,15,134,34,100,1271,1178,93,0
2021,Enfield 030,E02000306,3399,678,282,396,81,81,1717,931,786,896,827,69,27
2021,Enfield 031,E02000307,3343,1995,1042,953,7,7,277,176,101,1058,979,79,6
2021,Enfield 032,E02000308,3223,1592,802,790,57,57,574,316,258,995,920,75,5
2021,Enfield 033,E02000309,3986,1484,755,729,37,37,829,506,323,1626,1522,104,10
2021,Enfield 035,E02000311,3635,1885,1024,861,30,30,604,236,368,1104,1022,82,12
2021,Enfield 036,E02000312,4495,2155,1148,1007,99,99,357,106,251,1878,1764,114,6
2021,Greenwich 001,E02000313,2596,569,221,348,46,46,1627,208,1419,346,311,35,8
2021,Greenwich 002,E02000314,4537,1521,348,1173,165,165,1156,209,947,1679,1592,87,16
2021,Greenwich 003,E02000315,3490,1195,439,756,19,19,1488,1248,240,779,726,53,9
2021,Greenwich 005,E02000317,2822,709,257,452,40,40,1551,1055,496,508,465,43,14
2021,Greenwich 006,E02000318,3581,1297,549,748,13,13,851,470,381,1400,1269,131,20
2021,Greenwich 007,E02000319,3919,1297,509,788,78,78,1229,516,713,1302,1180,122,13
2021,Greenwich 008,E02000320,2556,1213,565,648,9,9,658,546,112,668,617,51,8
2021,Greenwich 009,E02000321,2964,780,286,494,32,32,1494,1249,245,648,606,42,10
2021,Greenwich 011,E02000323,4820,1258,439,819,164,164,1927,1248,679,1464,1378,86,7
2021,Greenwich 012,E02000324,2855,885,362,523,25,25,1436,780,656,497,448,49,12
2021,Greenwich 014,E02000326,3049,1489,584,905,33,33,832,281,551,694,591,103,1
2021,Greenwich 015,E02000327,2635,653,151,502,41,41,1207,944,263,726,534,192,8
2021,Greenwich 016,E02000328,2946,1439,603,836,87,87,741,509,232,675,638,37,4
2021,Greenwich 017,E02000329,2464,1373,644,729,14,14,587,334,253,484,429,55,6
2021,Greenwich 019,E02000331,3191,1299,478,821,31,31,1133,830,303,723,671,52,5
2021,Greenwich 020,E02000332,2999,1813,852,961,19,19,530,288,242,628,590,38,9
2021,Greenwich 021,E02000333,2884,1471,707,764,6,6,483,314,169,920,858,62,4
2021,Greenwich 022,E02000334,2543,1473,587,886,10,10,669,597,72,389,363,26,2
2021,Greenwich 023,E02000335,2591,1954,914,1040,12,12,354,162,192,269,234,35,2
2021,Greenwich 025,E02000337,3084,1390,531,859,76,76,1230,1002,228,383,339,44,5
2021,Greenwich 027,E02000339,2590,1658,836,822,26,26,519,281,238,382,345,37,5
2021,Greenwich 028,E02000340,3019,1866,986,880,33,33,469,368,101,647,584,63,4
2021,Greenwich 029,E02000341,2941,1201,464,737,13,13,1383,1225,158,328,286,42,16
2021,Greenwich 030,E02000342,2340,1188,481,707,60,60,704,495,209,384,350,34,4
2021,Greenwich 031,E02000343,2696,1537,701,836,8,8,837,726,111,309,275,34,5
2021,Greenwich 032,E02000344,2448,1819,853,966,12,12,292,203,89,320,273,47,5
2021,Hackney 001,E02000345,2589,661,381,280,99,99,575,191,384,1252,1130,122,2
2021,Hackney 002,E02000346,3972,557,230,327,185,185,1886,1123,763,1329,1240,89,15
2021,Hackney 003,E02000347,2582,614,299,315,27,27,866,483,383,1071,1016,55,4
2021,Hackney 004,E02000348,2721,467,254,213,36,36,1344,527,817,865,809,56,9
2021,Hackney 006,E02000350,3696,1154,516,638,76,76,888,274,614,1574,1473,101,4
2021,Hackney 007,E02000351,4228,1239,445,794,97,97,1181,573,608,1690,1615,75,21
2021,Hackney 008,E02000352,2686,924,390,534,57,57,995,480,515,704,652,52,6
2021,Hackney 009,E02000353,3156,1319,564,755,21,21,654,315,339,1160,1095,65,2
2021,Hackney 010,E02000354,3989,1026,317,709,68,68,1777,961,816,1109,1042,67,9
2021,Hackney 011,E02000355,3114,1291,591,700,48,48,745,319,426,1024,948,76,6
2021,Hackney 012,E02000356,3061,1276,480,796,37,37,731,401,330,1013,959,54,4
2021,Hackney 013,E02000357,2721,447,173,274,14,14,1812,847,965,440,402,38,8
2021,Hackney 014,E02000358,4817,1340,465,875,80,80,1787,958,829,1599,1480,119,11
2021,Hackney 015,E02000359,2434,995,402,593,22,22,780,400,380,636,608,28,1
2021,Hackney 016,E02000360,4850,862,300,562,103,103,2838,813,2025,1035,966,69,12
2021,Hackney 017,E02000361,3679,833,306,527,74,74,1288,618,670,1480,1419,61,4
2021,Hackney 018,E02000362,2805,646,201,445,132,132,1251,572,679,772,710,62,4
2021,Hackney 019,E02000363,4442,749,254,495,170,170,2742,1743,999,766,716,50,15
2021,Hackney 020,E02000364,4099,1288,558,730,98,98,1583,655,928,1125,1029,96,5
2021,Hackney 022,E02000366,3540,814,340,474,53,53,1973,689,1284,688,637,51,12
2021,Hackney 023,E02000367,4593,1129,373,756,189,189,1583,605,978,1682,1574,108,10
2021,Hackney 024,E02000368,4154,783,276,507,55,55,2402,1770,632,902,827,75,12
2021,Hackney 025,E02000369,5929,1011,344,667,360,360,2732,1654,1078,1808,1658,150,18
2021,Hackney 026,E02000370,3992,770,303,467,186,186,1885,1425,460,1140,1048,92,11
2021,Hammersmith and Fulham 001,E02000372,3877,804,436,368,109,109,1970,488,1482,987,874,113,7
2021,Hammersmith and Fulham 002,E02000373,2536,449,180,269,65,65,1579,1419,160,426,406,20,17
2021,Hammersmith and Fulham 003,E02000374,2621,880,416,464,30,30,967,357,610,742,674,68,2
2021,Hammersmith and Fulham 004,E02000375,3498,769,390,379,40,40,1424,774,650,1249,1158,91,16
2021,Hammersmith and Fulham 005,E02000376,3181,732,307,425,45,45,1045,358,687,1353,1275,78,6
2021,Hammersmith and Fulham 006,E02000377,3446,971,441,530,65,65,1184,446,738,1219,1150,69,7
2021,Hammersmith and Fulham 007,E02000378,3250,927,406,521,20,20,883,496,387,1409,1332,77,11
2021,Hammersmith and Fulham 008,E02000379,3104,1342,632,710,118,118,772,261,511,872,804,68,0
2021,Hammersmith and Fulham 009,E02000380,2497,1039,499,540,19,19,639,145,494,797,729,68,3
2021,Hammersmith and Fulham 010,E02000381,3546,1192,591,601,9,9,934,343,591,1407,1319,88,4
2021,Hammersmith and Fulham 011,E02000382,2772,1009,531,478,73,73,650,246,404,1038,964,74,2
2021,Hammersmith and Fulham 012,E02000383,4112,1241,688,553,25,25,919,432,487,1917,1794,123,10
2021,Hammersmith and Fulham 013,E02000384,3807,835,396,439,42,42,1485,732,753,1431,1313,118,14
2021,Hammersmith and Fulham 014,E02000385,2853,905,408,497,21,21,494,201,293,1430,1312,118,3
2021,Hammersmith and Fulham 015,E02000386,3366,655,293,362,35,35,1539,1138,401,1127,1056,71,10
2021,Hammersmith and Fulham 016,E02000387,2583,665,299,366,16,16,1074,661,413,823,757,66,5
2021,Hammersmith and Fulham 017,E02000388,4133,1210,543,667,58,58,1146,403,743,1715,1571,144,4
2021,Hammersmith and Fulham 018,E02000389,3678,1759,837,922,42,42,533,365,168,1343,1224,119,1
2021,Hammersmith and Fulham 019,E02000390,2719,991,456,535,12,12,648,244,404,1062,976,86,6
2021,Hammersmith and Fulham 020,E02000391,3279,1375,688,687,22,22,764,398,366,1113,1010,103,5
2021,Hammersmith and Fulham 021,E02000392,4039,1405,664,741,46,46,1014,750,264,1567,1458,109,7
2021,Hammersmith and Fulham 022,E02000393,2587,1206,554,652,18,18,306,138,168,1051,982,69,6
2021,Hammersmith and Fulham 023,E02000394,4346,1394,583,811,201,201,1191,434,757,1555,1399,156,5
2021,Hammersmith and Fulham 024,E02000395,2642,1267,738,529,31,31,311,145,166,1030,929,101,3
2021,Hammersmith and Fulham 025,E02000396,2769,1065,506,559,45,45,764,468,296,893,816,77,2
2021,Haringey 001,E02000397,3474,1068,495,573,38,38,858,406,452,1502,1408,94,8
2021,Haringey 002,E02000398,2879,639,296,343,31,31,1229,887,342,965,917,48,15
2021,Haringey 004,E02000400,3122,1269,635,634,70,70,921,502,419,847,800,47,15
2021,Haringey 005,E02000401,2477,867,341,526,20,20,1088,842,246,488,454,34,14
2021,Haringey 006,E02000402,2426,660,260,400,30,30,1104,822,282,612,574,38,20
2021,Haringey 007,E02000403,2991,1030,492,538,30,30,462,218,244,1466,1390,76,3
2021,Haringey 008,E02000404,2665,909,468,441,27,27,805,595,210,909,854,55,15
2021,Haringey 009,E02000405,2462,1688,816,872,9,9,187,113,74,576,540,36,2
2021,Haringey 010,E02000406,2594,825,374,451,20,20,901,829,72,830,757,73,18
2021,Haringey 011,E02000407,3006,794,353,441,60,60,913,370,543,1225,1163,62,14
2021,Haringey 012,E02000408,3000,738,348,390,71,71,1201,739,462,973,904,69,17
2021,Haringey 013,E02000409,2367,755,343,412,19,19,1023,691,332,545,495,50,25
2021,Haringey 014,E02000410,2614,1499,681,818,9,9,187,58,129,918,873,45,1
2021,Haringey 015,E02000411,3952,1204,502,702,129,129,1209,637,572,1387,1300,87,23
2021,Haringey 016,E02000412,2870,725,357,368,97,97,995,498,497,1045,985,60,8
2021,Haringey 017,E02000413,2966,1625,789,836,46,46,459,313,146,827,784,43,9
2021,Haringey 018,E02000414,2717,1057,499,558,19,19,449,172,277,1185,1088,97,7
2021,Haringey 019,E02000415,2836,1086,550,536,49,49,446,212,234,1251,1137,114,4
2021,Haringey 020,E02000416,3919,1261,461,800,144,144,1199,758,441,1297,1239,58,18
2021,Haringey 021,E02000417,2865,1619,851,768,17,17,245,128,117,980,919,61,4
2021,Haringey 022,E02000418,2208,1505,733,772,28,28,243,208,35,428,390,38,4
2021,Haringey 023,E02000419,3645,1278,575,703,35,35,496,221,275,1831,1764,67,5
2021,Haringey 024,E02000420,3434,981,424,557,58,58,1078,477,601,1294,1219,75,23
2021,Haringey 025,E02000421,3141,640,286,354,105,105,1252,649,603,1125,1037,88,19
2021,Haringey 026,E02000422,2887,931,420,511,47,47,838,562,276,1041,964,77,30
2021,Haringey 027,E02000423,2672,1029,480,549,27,27,432,293,139,1180,1121,59,4
2021,Haringey 028,E02000424,2983,1407,511,896,25,25,761,277,484,786,737,49,4
2021,Haringey 029,E02000425,2160,603,367,236,48,48,422,226,196,1081,993,88,6
2021,Haringey 030,E02000426,2747,1469,819,650,22,22,444,308,136,808,716,92,4
2021,Haringey 031,E02000427,2868,1157,515,642,46,46,359,148,211,1303,1244,59,3
2021,Haringey 032,E02000428,2920,670,303,367,45,45,1114,827,287,1083,1022,61,8
2021,Haringey 033,E02000429,3202,1674,833,841,91,91,411,148,263,1022,961,61,4
2021,Haringey 034,E02000430,3249,1462,629,833,35,35,418,148,270,1331,1274,57,3
2021,Haringey 035,E02000431,2846,1369,670,699,8,8,196,92,104,1268,1197,71,5
2021,Haringey 036,E02000432,2800,1085,416,669,11,11,706,421,285,992,931,61,6
2021,Harrow 001,E02000433,3542,2193,1251,942,31,31,410,123,287,906,813,93,2
2021,Harrow 002,E02000434,3638,2140,1180,960,100,100,310,154,156,1083,958,125,5
2021,Harrow 003,E02000435,2809,1623,870,753,36,36,541,369,172,599,466,133,10
2021,Harrow 004,E02000436,2043,1720,934,786,6,6,70,57,13,246,215,31,1
2021,Harrow 005,E02000437,3088,1956,1039,917,23,23,338,156,182,767,708,59,4
2021,Harrow 006,E02000438,3046,1709,894,815,12,12,626,378,248,690,629,61,9
2021,Harrow 007,E02000439,2948,1585,847,738,31,31,304,245,59,1022,957,65,6
2021,Harrow 008,E02000440,3055,2335,1183,1152,6,6,99,79,20,612,539,73,3
2021,Harrow 009,E02000441,2795,1668,888,780,23,23,501,380,121,593,539,54,10
2021,Harrow 010,E02000442,2667,1541,840,701,9,9,111,64,47,1006,929,77,0
2021,Harrow 011,E02000443,3546,1606,751,855,34,34,545,326,219,1352,1274,78,9
2021,Harrow 012,E02000444,2670,1760,946,814,9,9,73,37,36,824,755,69,4
2021,Harrow 013,E02000445,3820,1773,874,899,116,116,524,188,336,1399,1322,77,8
2021,Harrow 015,E02000447,2744,1984,873,1111,19,19,201,109,92,539,489,50,1
2021,Harrow 016,E02000448,2759,1927,1081,846,29,29,212,129,83,589,555,34,2
2021,Harrow 017,E02000449,2527,1335,771,564,15,15,425,306,119,742,659,83,10
2021,Harrow 019,E02000451,2329,1791,949,842,21,21,44,30,14,470,417,53,3
2021,Harrow 020,E02000452,3451,1484,655,829,41,41,227,71,156,1695,1601,94,4
2021,Harrow 021,E02000453,3046,1641,820,821,56,56,226,85,141,1116,1055,61,7
2021,Harrow 022,E02000454,2524,2056,1014,1042,3,3,101,67,34,362,330,32,2
2021,Harrow 023,E02000455,4758,1839,761,1078,80,80,636,289,347,2193,2096,97,10
2021,Harrow 024,E02000456,2716,1584,820,764,32,32,273,161,112,818,770,48,9
2021,Harrow 025,E02000457,2563,1603,827,776,65,65,190,32,158,701,641,60,4
2021,Harrow 027,E02000459,3418,1493,701,792,59,59,593,316,277,1266,1209,57,7
2021,Harrow 028,E02000460,2415,1159,431,728,19,19,659,156,503,574,523,51,4
2021,Harrow 029,E02000461,2557,1349,632,717,30,30,138,94,44,1037,882,155,3
2021,Harrow 030,E02000462,2285,1262,652,610,20,20,182,48,134,821,745,76,0
2021,Harrow 031,E02000463,2834,1650,740,910,14,14,518,387,131,640,593,47,12
2021,Havering 001,E02000464,2873,1726,756,970,15,15,799,676,123,331,293,38,2
2021,Havering 002,E02000465,3494,1845,679,1166,29,29,1150,994,156,466,421,45,4
2021,Havering 003,E02000466,3293,2111,1037,1074,37,37,760,591,169,384,331,53,1
2021,Havering 004,E02000467,4289,1616,573,1043,51,51,2040,1719,321,563,492,71,19
2021,Havering 005,E02000468,3167,2324,1121,1203,25,25,366,254,112,447,394,53,5
2021,Havering 006,E02000469,2699,1503,615,888,17,17,815,654,161,357,320,37,7
2021,Havering 007,E02000470,4132,3012,1438,1574,43,43,322,140,182,752,670,82,3
2021,Havering 008,E02000471,2943,2644,1507,1137,9,9,58,42,16,230,196,34,2
2021,Havering 009,E02000472,3527,2781,1356,1425,20,20,242,215,27,484,427,57,0
2021,Havering 010,E02000473,4022,3104,1439,1665,97,97,247,105,142,572,529,43,2
2021,Havering 011,E02000474,3531,2317,1038,1279,56,56,516,411,105,639,592,47,3
2021,Havering 012,E02000475,3958,2765,1433,1332,35,35,412,241,171,742,689,53,4
2021,Havering 013,E02000476,4198,1757,758,999,150,150,752,276,476,1537,1456,81,2
2021,Havering 014,E02000477,3714,3137,1615,1522,6,6,99,62,37,472,431,41,0
2021,Havering 015,E02000478,2150,1902,1111,791,3,3,114,15,99,130,111,19,1
2021,Havering 016,E02000479,3789,2141,907,1234,47,47,460,319,141,1133,1061,72,8
2021,Havering 017,E02000480,5012,2659,1110,1549,84,84,948,378,570,1311,1217,94,10
2021,Havering 018,E02000481,3246,2636,1484,1152,19,19,239,217,22,349,281,68,3
2021,Havering 019,E02000482,2577,2317,1308,1009,4,4,49,40,9,207,184,23,0
2021,Havering 020,E02000483,3473,2283,1272,1011,6,6,470,286,184,712,663,49,2
2021,Havering 021,E02000484,3253,2663,1363,1300,13,13,194,150,44,380,331,49,3
2021,Havering 022,E02000485,3458,2609,1315,1294,10,10,198,171,27,640,579,61,1
2021,Havering 023,E02000486,2990,2422,1299,1123,4,4,100,62,38,463,402,61,1
2021,Havering 024,E02000487,2944,2740,1603,1137,5,5,39,27,12,160,130,30,0
2021,Havering 025,E02000488,3014,2642,1497,1145,17,17,87,53,34,268,225,43,0
2021,Havering 026,E02000489,3260,2312,1138,1174,27,27,488,404,84,430,376,54,3
2021,Havering 027,E02000490,3227,2366,1216,1150,16,16,428,306,122,414,356,58,3
2021,Havering 028,E02000491,3931,2338,1018,1320,102,102,936,386,550,550,484,66,5
2021,Havering 029,E02000492,2625,2196,1244,952,10,10,128,40,88,287,255,32,4
2021,Havering 030,E02000493,2497,1511,668,843,23,23,352,193,159,609,556,53,2
2021,Hillingdon 001,E02000494,3219,2163,1161,1002,8,8,426,117,309,622,536,86,0
2021,Hillingdon 002,E02000495,4304,2307,1238,1069,18,18,571,346,225,1408,1322,86,0
2021,Hillingdon 003,E02000496,3176,2089,1049,1040,20,20,637,504,133,428,366,62,2
2021,Hillingdon 004,E02000497,3695,2395,1172,1223,39,39,700,462,238,558,487,71,3
2021,Hillingdon 005,E02000498,2637,1860,943,917,22,22,424,257,167,329,284,45,2
2021,Hillingdon 006,E02000499,3014,2406,1338,1068,10,10,171,133,38,427,395,32,0
2021,Hillingdon 007,E02000500,3306,2357,1322,1035,35,35,195,27,168,719,669,50,0
2021,Hillingdon 008,E02000501,3274,2514,1211,1303,12,12,239,120,119,506,453,53,3
2021,Hillingdon 009,E02000502,3534,2347,1114,1233,52,52,193,114,79,940,739,201,2
2021,Hillingdon 010,E02000503,3255,2555,1184,1371,22,22,113,37,76,563,435,128,2
2021,Hillingdon 011,E02000504,2922,2385,1287,1098,9,9,112,85,27,414,317,97,2
2021,Hillingdon 013,E02000506,2899,2328,1287,1041,5,5,175,53,122,391,335,56,0
2021,Hillingdon 014,E02000507,2785,2023,866,1157,17,17,262,191,71,483,441,42,0
2021,Hillingdon 015,E02000508,4340,2034,772,1262,98,98,733,387,346,1471,1243,228,4
2021,Hillingdon 016,E02000509,3402,1386,661,725,66,66,813,582,231,1127,1045,82,10
2021,Hillingdon 017,E02000510,3260,2083,1011,1072,14,14,410,189,221,750,688,62,3
2021,Hillingdon 018,E02000511,3262,2196,990,1206,68,68,267,150,117,730,656,74,1
2021,Hillingdon 019,E02000512,3106,1435,607,828,35,35,804,574,230,828,776,52,4
2021,Hillingdon 020,E02000513,3320,1405,535,870,42,42,959,703,256,910,851,59,4
2021,Hillingdon 021,E02000514,3180,1812,856,956,26,26,237,109,128,1104,996,108,1
2021,Hillingdon 022,E02000515,5345,2213,887,1326,148,148,1144,626,518,1831,1722,109,9
2021,Hillingdon 023,E02000516,2818,1464,657,807,54,54,537,102,435,760,699,61,3
2021,Hillingdon 024,E02000517,3320,1533,588,945,38,38,831,548,283,916,863,53,2
2021,Hillingdon 025,E02000518,3330,1544,649,895,39,39,1031,741,290,710,656,54,6
2021,Hillingdon 026,E02000519,3024,1214,508,706,49,49,1019,694,325,723,663,60,19
2021,Hillingdon 027,E02000520,4455,1787,720,1067,96,96,942,467,475,1619,1507,112,11
2021,Hillingdon 028,E02000521,4352,1878,658,1220,129,129,1156,492,664,1184,1110,74,5
2021,Hillingdon 029,E02000522,3490,1679,745,934,47,47,867,484,383,894,816,78,3
2021,Hillingdon 030,E02000523,3683,1673,746,927,87,87,415,96,319,1497,1403,94,11
2021,Hillingdon 031,E02000524,2639,1124,601,523,14,14,362,161,201,1136,1072,64,3
2021,Hillingdon 032,E02000525,3318,1346,609,737,22,22,537,364,173,1396,1312,84,17
2021,Hounslow 001,E02000526,3617,1881,978,903,48,48,407,215,192,1280,1200,80,1
2021,Hounslow 004,E02000529,3037,1514,643,871,52,52,555,367,188,906,819,87,10
2021,Hounslow 005,E02000530,2516,846,355,491,35,35,1066,915,151,551,493,58,18
2021,Hounslow 006,E02000531,4936,2249,950,1299,204,204,1059,755,304,1412,1308,104,12
2021,Hounslow 007,E02000532,3819,2106,1079,1027,15,15,769,583,186,917,829,88,12
2021,Hounslow 008,E02000533,3689,1947,925,1022,16,16,643,395,248,1073,991,82,10
2021,Hounslow 009,E02000534,3001,1711,833,878,53,53,200,34,166,1037,930,107,0
2021,Hounslow 010,E02000535,3006,1664,909,755,27,27,408,246,162,897,823,74,10
2021,Hounslow 011,E02000536,3246,1625,839,786,78,78,523,179,344,1004,932,72,16
2021,Hounslow 012,E02000537,3158,1652,909,743,8,8,86,35,51,1408,1318,90,4
2021,Hounslow 013,E02000538,3004,1266,669,597,38,38,449,383,66,1243,1100,143,8
2021,Hounslow 014,E02000539,4737,2215,815,1400,131,131,1085,507,578,1302,1198,104,4
2021,Hounslow 015,E02000540,4487,1791,767,1024,204,204,919,346,573,1561,1486,75,12
2021,Hounslow 016,E02000541,3281,1150,682,468,28,28,952,327,625,1137,1047,90,14
2021,Hounslow 017,E02000542,3952,1249,635,614,116,116,950,519,431,1623,1536,87,14
2021,Hounslow 018,E02000543,4894,1560,759,801,113,113,648,277,371,2564,2458,106,9
2021,Hounslow 019,E02000544,2923,1989,1007,982,22,22,142,78,64,765,702,63,5
2021,Hounslow 020,E02000545,3548,1591,648,943,40,40,1180,966,214,733,687,46,4
2021,Hounslow 021,E02000546,3157,1471,727,744,54,54,486,218,268,1144,1078,66,2
2021,Hounslow 022,E02000547,3852,1920,844,1076,31,31,920,755,165,944,871,73,37
2021,Hounslow 023,E02000548,3726,1433,549,884,269,269,1237,688,549,777,726,51,10
2021,Hounslow 024,E02000549,4078,2335,1033,1302,50,50,738,487,251,946,836,110,9
2021,Hounslow 025,E02000550,3718,1437,494,943,128,128,1226,737,489,922,858,64,5
2021,Hounslow 026,E02000551,3415,1253,500,753,68,68,1473,823,650,605,562,43,16
2021,Hounslow 027,E02000552,3360,1914,738,1176,106,106,387,161,226,947,899,48,6
2021,Hounslow 028,E02000553,2599,1552,691,861,52,52,550,458,92,439,400,39,6
2021,Islington 001,E02000554,4200,982,385,597,36,36,2173,1584,589,973,921,52,36
2021,Islington 002,E02000555,4032,1366,589,777,74,74,1489,1028,461,1093,1035,58,10
2021,Islington 003,E02000556,4949,1444,555,889,58,58,1552,957,595,1855,1756,99,40
2021,Islington 004,E02000557,4139,968,388,580,38,38,1811,963,848,1311,1238,73,11
2021,Islington 005,E02000558,3957,576,257,319,28,28,2308,1633,675,1020,954,66,25
2021,Islington 006,E02000559,3998,1532,635,897,53,53,1039,531,508,1372,1277,95,2
2021,Islington 007,E02000560,3273,945,400,545,30,30,817,428,389,1474,1382,92,7
2021,Islington 008,E02000561,3158,1442,691,751,19,19,758,270,488,937,864,73,2
2021,Islington 009,E02000562,3488,1193,503,690,34,34,1321,971,350,923,852,71,17
2021,Islington 010,E02000563,3859,866,337,529,48,48,1857,1358,499,1070,984,86,18
2021,Islington 011,E02000564,5663,1356,493,863,276,276,1906,957,949,2115,1995,120,10
2021,Islington 012,E02000565,3496,809,317,492,34,34,1633,1297,336,1009,923,86,11
2021,Islington 013,E02000566,3839,1405,666,739,62,62,1070,570,500,1294,1206,88,8
2021,Islington 014,E02000567,4894,1422,551,871,51,51,1970,1460,510,1442,1348,94,9
2021,Islington 015,E02000568,4669,832,325,507,140,140,2426,1269,1157,1252,1171,81,19
2021,Islington 016,E02000569,4603,1170,536,634,73,73,2171,1373,798,1176,1075,101,13
2021,Islington 017,E02000570,3990,1498,738,760,14,14,1077,530,547,1397,1294,103,4
2021,Islington 018,E02000571,4122,1035,419,616,45,45,1888,1211,677,1139,1068,71,15
2021,Islington 019,E02000572,3523,464,209,255,46,46,2147,918,1229,854,809,45,12
2021,Islington 020,E02000573,4920,1508,798,710,178,178,1433,733,700,1799,1694,105,2
2021,Islington 021,E02000574,3605,894,445,449,54,54,1331,829,502,1318,1227,91,8
2021,Islington 022,E02000575,5170,1209,559,650,64,64,2028,1584,444,1855,1709,146,14
2021,Islington 023,E02000576,4949,822,354,468,129,129,2581,1628,953,1403,1302,101,14
2021,Kensington and Chelsea 001,E02000577,3175,352,156,196,67,67,2252,1317,935,491,421,70,13
2021,Kensington and Chelsea 002,E02000578,2309,274,140,134,87,87,1676,527,1149,246,200,46,26
2021,Kensington and Chelsea 003,E02000579,3820,1089,583,506,88,88,1740,549,1191,895,798,97,8
2021,Kensington and Chelsea 004,E02000580,3989,677,349,328,33,33,2185,571,1614,1082,986,96,12
2021,Kensington and Chelsea 005,E02000581,3011,350,199,151,88,88,2098,1234,864,458,414,44,17
2021,Kensington and Chelsea 006,E02000582,3270,1177,763,414,46,46,484,128,356,1557,1383,174,6
2021,Kensington and Chelsea 007,E02000583,3119,1269,786,483,21,21,693,126,567,1135,991,144,1
2021,Kensington and Chelsea 008,E02000584,3331,1528,1015,513,22,22,277,130,147,1501,1317,184,3
2021,Kensington and Chelsea 009,E02000585,3387,1333,844,489,34,34,572,147,425,1446,1287,159,2
2021,Kensington and Chelsea 010,E02000586,2883,1211,843,368,14,14,130,25,105,1526,1337,189,2
2021,Kensington and Chelsea 011,E02000587,3026,1304,871,433,6,6,153,38,115,1561,1425,136,2
2021,Kensington and Chelsea 012,E02000588,3077,1064,728,336,17,17,145,78,67,1849,1604,245,2
2021,Kensington and Chelsea 013,E02000589,3660,1123,665,458,17,17,372,28,344,2148,1981,167,0
2021,Kensington and Chelsea 014,E02000590,3047,820,576,244,8,8,984,352,632,1231,1108,123,4
2021,Kensington and Chelsea 015,E02000591,3241,767,456,311,36,36,1019,164,855,1415,1322,93,4
2021,Kensington and Chelsea 016,E02000592,2840,1081,723,358,8,8,226,30,196,1525,1357,168,0
2021,Kensington and Chelsea 017,E02000593,3684,1171,640,531,16,16,639,161,478,1851,1699,152,7
2021,Kensington and Chelsea 018,E02000594,2922,1183,805,378,8,8,487,132,355,1240,1037,203,4
2021,Kensington and Chelsea 019,E02000595,3025,1353,914,439,10,10,499,338,161,1156,984,172,7
2021,Kensington and Chelsea 020,E02000596,3073,1252,790,462,11,11,354,194,160,1454,1300,154,2
2021,Kensington and Chelsea 021,E02000597,2997,813,456,357,38,38,1448,886,562,694,610,84,4
2021,Kingston upon Thames 001,E02000598,2970,2275,1137,1138,21,21,216,56,160,455,422,33,3
2021,Kingston upon Thames 002,E02000599,2354,1806,996,810,5,5,80,66,14,461,403,58,2
2021,Kingston upon Thames 003,E02000600,3377,1732,798,934,8,8,418,329,89,1211,1112,99,8
2021,Kingston upon Thames 004,E02000601,4857,2555,1129,1426,95,95,571,283,288,1628,1441,187,8
2021,Kingston upon Thames 005,E02000602,4049,1614,660,954,35,35,1159,908,251,1225,1152,73,16
2021,Kingston upon Thames 006,E02000603,2953,1444,648,796,53,53,689,453,236,762,706,56,5
2021,Kingston upon Thames 007,E02000604,3559,2189,1011,1178,36,36,236,168,68,1096,1014,82,2
2021,Kingston upon Thames 008,E02000605,3115,2203,1103,1100,7,7,184,110,74,718,657,61,3
2021,Kingston upon Thames 009,E02000606,4811,2211,1018,1193,25,25,336,162,174,2236,2114,122,3
2021,Kingston upon Thames 010,E02000607,2583,1663,750,913,5,5,205,139,66,709,667,42,1
2021,Kingston upon Thames 011,E02000608,3405,1495,599,896,13,13,313,98,215,1582,1508,74,2
2021,Kingston upon Thames 012,E02000609,2740,1861,980,881,10,10,342,294,48,522,470,52,5
2021,Kingston upon Thames 013,E02000610,3871,1631,661,970,21,21,650,408,242,1561,1488,73,8
2021,Kingston upon Thames 014,E02000611,2652,2299,1200,1099,12,12,68,44,24,272,245,27,1
2021,Kingston upon Thames 015,E02000612,3080,2453,1277,1176,8,8,135,81,54,483,435,48,1
2021,Kingston upon Thames 016,E02000613,3192,2055,798,1257,13,13,349,207,142,774,733,41,1
2021,Kingston upon Thames 017,E02000614,3374,2094,863,1231,35,35,295,181,114,946,856,90,4
2021,Kingston upon Thames 018,E02000615,2956,2239,1053,1186,18,18,209,165,44,488,425,63,2
2021,Kingston upon Thames 019,E02000616,2390,1915,843,1072,21,21,132,75,57,321,284,37,1
2021,Kingston upon Thames 020,E02000617,3344,2205,994,1211,18,18,656,419,237,463,403,60,2
2021,Lambeth 002,E02000619,4054,1037,418,619,47,47,2135,1361,774,825,732,93,10
2021,Lambeth 003,E02000620,4590,1111,506,605,219,219,1886,1133,753,1370,1223,147,4
2021,Lambeth 004,E02000621,6007,1474,655,819,183,183,1761,548,1213,2582,2389,193,7
2021,Lambeth 005,E02000622,3633,1004,388,616,22,22,1363,664,699,1238,1145,93,6
2021,Lambeth 006,E02000623,3330,696,303,393,18,18,1762,1006,756,843,770,73,11
2021,Lambeth 007,E02000624,4272,1110,339,771,158,158,1746,1072,674,1246,1169,77,12
2021,Lambeth 008,E02000625,3799,680,216,464,58,58,1855,1143,712,1200,1115,85,6
2021,Lambeth 009,E02000626,3449,647,170,477,31,31,2176,1627,549,578,531,47,17
2021,Lambeth 010,E02000627,3915,990,375,615,82,82,1641,502,1139,1193,1125,68,9
2021,Lambeth 011,E02000628,4481,884,249,635,146,146,2342,1289,1053,1094,1012,82,15
2021,Lambeth 012,E02000629,4017,1310,480,830,79,79,1122,685,437,1503,1402,101,3
2021,Lambeth 013,E02000630,3431,1271,545,726,39,39,835,625,210,1281,1187,94,5
2021,Lambeth 014,E02000631,3739,1490,549,941,50,50,1040,281,759,1158,1067,91,1
2021,Lambeth 015,E02000632,4259,1390,453,937,55,55,914,276,638,1899,1782,117,1
2021,Lambeth 016,E02000633,3962,965,366,599,92,92,1753,913,840,1142,1025,117,10
2021,Lambeth 017,E02000634,3108,737,276,461,28,28,1323,1008,315,1015,942,73,5
2021,Lambeth 018,E02000635,4335,1398,485,913,211,211,1585,479,1106,1139,1032,107,2
2021,Lambeth 019,E02000636,3081,1557,583,974,16,16,462,298,164,1043,966,77,3
2021,Lambeth 020,E02000637,3704,1526,566,960,22,22,718,282,436,1438,1352,86,0
2021,Lambeth 021,E02000638,4107,1326,378,948,79,79,1503,1042,461,1192,1099,93,7
2021,Lambeth 022,E02000639,3726,779,267,512,170,170,1621,568,1053,1150,1026,124,6
2021,Lambeth 023,E02000640,3804,1761,598,1163,17,17,918,498,420,1105,1033,72,3
2021,Lambeth 024,E02000641,3391,792,238,554,46,46,1923,1026,897,627,571,56,3
2021,Lambeth 025,E02000642,4170,1640,634,1006,31,31,1380,436,944,1114,1031,83,5
2021,Lambeth 026,E02000643,3946,1571,492,1079,54,54,971,689,282,1343,1269,74,7
2021,Lambeth 027,E02000644,3496,1734,582,1152,25,25,672,350,322,1064,976,88,1
2021,Lambeth 028,E02000645,4048,1730,614,1116,61,61,850,436,414,1401,1311,90,6
2021,Lambeth 029,E02000646,3903,1860,703,1157,27,27,451,156,295,1564,1474,90,1
2021,Lambeth 030,E02000647,3422,1854,727,1127,74,74,645,357,288,848,771,77,1
2021,Lambeth 031,E02000648,3188,1077,331,746,41,41,1538,1154,384,520,481,39,12
2021,Lambeth 032,E02000649,5304,2027,596,1431,103,103,802,429,373,2363,2284,79,9
2021,Lambeth 033,E02000650,3277,1224,372,852,25,25,1159,788,371,864,826,38,5
2021,Lambeth 034,E02000651,3479,1675,643,1032,46,46,587,281,306,1166,1081,85,5
2021,Lambeth 035,E02000652,2545,1370,677,693,31,31,434,121,313,708,653,55,2
2021,Lewisham 001,E02000653,5294,1228,300,928,250,250,2127,1092,1035,1684,1599,85,5
2021,Lewisham 002,E02000654,3596,742,195,547,68,68,1922,1339,583,849,794,55,15
2021,Lewisham 003,E02000655,4009,1065,323,742,157,157,1361,799,562,1417,1347,70,9
2021,Lewisham 005,E02000657,3988,1209,405,804,98,98,1234,587,647,1442,1358,84,5
2021,Lewisham 006,E02000658,3458,1198,442,756,68,68,1178,657,521,1011,923,88,3
2021,Lewisham 007,E02000659,3541,1347,541,806,105,105,1038,505,533,1045,977,68,6
2021,Lewisham 008,E02000660,3602,1349,436,913,43,43,913,547,366,1294,1205,89,3
2021,Lewisham 009,E02000661,3044,1306,612,694,4,4,674,485,189,1056,979,77,4
2021,Lewisham 010,E02000662,3303,1200,342,858,76,76,1253,768,485,765,705,60,9
2021,Lewisham 011,E02000663,2819,1432,586,846,23,23,634,232,402,729,669,60,1
2021,Lewisham 013,E02000665,3415,1643,632,1011,27,27,840,304,536,901,823,78,4
2021,Lewisham 014,E02000666,2735,1428,542,886,15,15,610,263,347,680,623,57,2
2021,Lewisham 015,E02000667,2525,1634,614,1020,29,29,287,91,196,572,512,60,3
2021,Lewisham 016,E02000668,2731,1653,692,961,16,16,436,153,283,624,578,46,2
2021,Lewisham 017,E02000669,3309,1472,501,971,55,55,657,170,487,1124,1067,57,1
2021,Lewisham 018,E02000670,2783,1132,437,695,20,20,767,196,571,860,799,61,4
2021,Lewisham 019,E02000671,3683,1917,644,1273,36,36,722,271,451,1004,929,75,4
2021,Lewisham 020,E02000672,4198,1703,536,1167,86,86,986,283,703,1421,1291,130,2
2021,Lewisham 021,E02000673,3494,1850,707,1143,14,14,622,270,352,1003,944,59,5
2021,Lewisham 022,E02000674,3057,1989,758,1231,10,10,330,88,242,727,677,50,1
2021,Lewisham 023,E02000675,3420,2001,880,1121,45,45,666,109,557,705,640,65,3
2021,Lewisham 024,E02000676,3190,1752,582,1170,23,23,619,196,423,793,736,57,3
2021,Lewisham 025,E02000677,2643,1655,708,947,23,23,346,85,261,615,558,57,4
2021,Lewisham 026,E02000678,2615,1224,463,761,24,24,777,213,564,586,541,45,4
2021,Lewisham 027,E02000679,3375,1619,617,1002,36,36,975,655,320,736,671,65,9
2021,Lewisham 028,E02000680,2913,1293,459,834,51,51,921,430,491,636,571,65,12
2021,Lewisham 029,E02000681,3351,1470,577,893,25,25,1110,448,662,740,655,85,6
2021,Lewisham 030,E02000682,3218,1415,618,797,42,42,1129,311,818,632,565,67,0
2021,Lewisham 031,E02000683,2724,1142,423,719,37,37,965,202,763,579,528,51,1
2021,Lewisham 033,E02000685,3422,1418,541,877,30,30,1277,615,662,694,640,54,3
2021,Lewisham 034,E02000686,3044,861,309,552,69,69,1455,557,898,652,578,74,7
2021,Lewisham 035,E02000687,3455,1575,638,937,21,21,1054,673,381,796,748,48,9
2021,Merton 001,E02000689,3512,2070,884,1186,62,62,314,82,232,1065,1003,62,1
2021,Merton 002,E02000690,2224,1594,1021,573,4,4,175,25,150,451,388,63,0
2021,Merton 003,E02000691,2957,1568,700,868,24,24,273,49,224,1090,1021,69,2
2021,Merton 004,E02000692,3568,1743,1006,737,11,11,332,24,308,1481,1377,104,1
2021,Merton 005,E02000693,4286,1822,698,1124,194,194,387,63,324,1883,1784,99,0
2021,Merton 006,E02000694,3833,2017,720,1297,9,9,535,82,453,1268,1205,63,4
2021,Merton 007,E02000695,2943,1844,916,928,22,22,132,34,98,945,865,80,0
2021,Merton 008,E02000696,3270,1356,512,844,23,23,616,124,492,1274,1211,63,1
2021,Merton 009,E02000697,3667,1945,807,1138,19,19,164,28,136,1539,1463,76,0
2021,Merton 010,E02000698,3183,2220,1150,1070,21,21,188,33,155,753,700,53,1
2021,Merton 011,E02000699,3262,2077,896,1181,10,10,152,26,126,1022,956,66,1
2021,Merton 012,E02000700,3354,1194,520,674,21,21,1153,248,905,982,917,65,4
2021,Merton 013,E02000701,3114,1545,719,826,49,49,476,81,395,1044,938,106,0
2021,Merton 014,E02000702,3367,1652,630,1022,96,96,913,185,728,706,641,65,0
2021,Merton 015,E02000703,2938,2188,1181,1007,18,18,148,17,131,584,537,47,0
2021,Merton 016,E02000704,3570,1797,779,1018,23,23,485,98,387,1265,1190,75,0
2021,Merton 017,E02000705,3117,2130,932,1198,27,27,176,27,149,783,698,85,1
2021,Merton 018,E02000706,3535,1273,488,785,61,61,1315,333,982,882,821,61,4
2021,Merton 019,E02000707,2778,1371,584,787,12,12,851,128,723,543,483,60,1
2021,Merton 020,E02000708,3257,2344,1047,1297,36,36,172,44,128,698,625,73,7
2021,Merton 021,E02000709,2870,2315,1196,1119,8,8,149,26,123,397,349,48,1
2021,Merton 022,E02000710,3438,1777,840,937,54,54,682,156,526,922,847,75,3
2021,Merton 023,E02000711,3456,1622,647,975,21,21,684,203,481,1128,1046,82,1
2021,Merton 024,E02000712,3403,1684,757,927,28,28,1058,216,842,629,570,59,4
2021,Merton 025,E02000713,2828,2324,1069,1255,15,15,72,14,58,416,364,52,1
2021,Newham 001,E02000714,2647,978,411,567,77,77,706,343,363,882,819,63,4
2021,Newham 002,E02000715,2094,676,312,364,21,21,531,401,130,859,802,57,7
2021,Newham 003,E02000716,2302,797,378,419,31,31,544,264,280,924,859,65,6
2021,Newham 004,E02000717,2395,791,397,394,29,29,538,316,222,1029,960,69,8
2021,Newham 005,E02000718,2246,696,306,390,38,38,864,717,147,640,570,70,8
2021,Newham 006,E02000719,2874,851,347,504,40,40,903,395,508,1070,1014,56,10
2021,Newham 007,E02000720,2123,999,527,472,19,19,333,119,214,765,697,68,7
2021,Newham 008,E02000721,2763,918,531,387,18,18,550,281,269,1268,1094,174,9
2021,Newham 009,E02000722,2934,794,347,447,67,67,919,455,464,1144,1066,78,10
2021,Newham 010,E02000723,2861,1323,785,538,16,16,338,198,140,1180,1053,127,4
2021,Newham 011,E02000724,2533,1125,595,530,16,16,351,178,173,1036,938,98,5
2021,Newham 012,E02000725,3997,860,318,542,135,135,1309,696,613,1660,1577,83,33
2021,Newham 014,E02000727,2291,848,495,353,10,10,343,223,120,1081,990,91,9
2021,Newham 015,E02000728,2343,961,470,491,12,12,232,124,108,1137,1032,105,1
2021,Newham 016,E02000729,2201,849,439,410,18,18,503,165,338,826,749,77,5
2021,Newham 017,E02000730,2564,1069,633,436,9,9,391,125,266,1091,998,93,4
2021,Newham 018,E02000731,2773,1076,546,530,20,20,418,214,204,1252,1145,107,7
2021,Newham 019,E02000732,2753,787,293,494,55,55,947,597,350,960,888,72,4
2021,Newham 020,E02000733,3460,951,398,553,57,57,1399,1170,229,1040,998,42,13
2021,Newham 021,E02000734,2495,591,251,340,72,72,1053,698,355,761,701,60,18
2021,Newham 022,E02000735,2657,839,384,455,59,59,815,448,367,938,874,64,6
2021,Newham 023,E02000736,2649,945,331,614,19,19,788,615,173,890,811,79,7
2021,Newham 024,E02000737,3066,1303,532,771,27,27,755,590,165,972,895,77,9
2021,Newham 025,E02000738,2786,1343,504,839,55,55,374,223,151,1012,939,73,2
2021,Newham 026,E02000739,2478,712,308,404,78,78,824,467,357,857,777,80,7
2021,Newham 027,E02000740,2495,602,212,390,27,27,1173,669,504,685,638,47,8
2021,Newham 028,E02000741,2681,1126,453,673,22,22,662,458,204,861,781,80,10
2021,Newham 029,E02000742,2528,1020,374,646,20,20,680,507,173,802,734,68,6
2021,Newham 030,E02000743,3578,805,280,525,138,138,1479,1043,436,1147,1054,93,9
2021,Newham 031,E02000744,3326,936,334,602,97,97,962,526,436,1312,1224,88,19
2021,Newham 032,E02000745,2876,892,323,569,64,64,1011,453,558,908,847,61,1
2021,Newham 033,E02000746,3394,788,171,617,145,145,1372,307,1065,1085,1041,44,4
2021,Newham 034,E02000747,5448,1139,310,829,194,194,1597,1012,585,2505,2391,114,13
2021,Newham 035,E02000748,2210,774,282,492,18,18,514,217,297,901,842,59,3
2021,Newham 036,E02000749,3330,765,219,546,107,107,1631,978,653,814,756,58,13
2021,Redbridge 001,E02000751,4438,3286,1834,1452,13,13,249,92,157,887,796,91,3
2021,Redbridge 002,E02000752,3266,1785,617,1168,130,130,871,668,203,469,415,54,11
2021,Redbridge 003,E02000753,2475,1410,596,814,27,27,540,409,131,484,444,40,14
2021,Redbridge 004,E02000754,2588,1729,777,952,10,10,380,270,110,462,416,46,7
2021,Redbridge 005,E02000755,2188,1481,650,831,9,9,268,221,47,425,382,43,5
2021,Redbridge 006,E02000756,5256,3227,1485,1742,43,43,533,373,160,1446,1307,139,7
2021,Redbridge 007,E02000757,5179,2983,1366,1617,50,50,438,187,251,1703,1598,105,5
2021,Redbridge 008,E02000758,2317,1634,773,861,19,19,319,187,132,341,295,46,4
2021,Redbridge 009,E02000759,4818,2899,1265,1634,27,27,726,533,193,1154,1063,91,12
2021,Redbridge 010,E02000760,2628,1508,710,798,29,29,468,286,182,616,566,50,7
2021,Redbridge 012,E02000762,2104,1557,813,744,7,7,83,68,15,456,406,50,1
2021,Redbridge 013,E02000763,2579,1450,684,766,33,33,392,269,123,703,639,64,1
2021,Redbridge 014,E02000764,5368,3192,1616,1576,22,22,554,260,294,1592,1468,124,8
2021,Redbridge 015,E02000765,2427,1420,682,738,8,8,188,115,73,806,724,82,5
2021,Redbridge 017,E02000767,2769,1628,719,909,44,44,203,101,102,881,807,74,13
2021,Redbridge 018,E02000768,2201,1625,846,779,4,4,230,77,153,340,312,28,2
2021,Redbridge 020,E02000770,2489,1365,647,718,15,15,153,95,58,942,877,65,14
2021,Redbridge 022,E02000772,2539,1253,558,695,10,10,289,76,213,985,925,60,2
2021,Redbridge 023,E02000773,3112,1628,726,902,27,27,468,182,286,976,912,64,13
2021,Redbridge 024,E02000774,2459,1200,622,578,5,5,108,47,61,1145,1065,80,1
2021,Redbridge 026,E02000776,2082,1094,597,497,10,10,156,69,87,816,748,68,6
2021,Redbridge 027,E02000777,2325,1597,818,779,8,8,306,220,86,410,371,39,4
2021,Redbridge 029,E02000779,2774,901,470,431,33,33,260,151,109,1572,1483,89,8
2021,Redbridge 031,E02000781,4427,2845,1250,1595,22,22,337,196,141,1218,1080,138,5
2021,Redbridge 032,E02000782,3577,1045,504,541,167,167,718,319,399,1634,1555,79,13
2021,Redbridge 033,E02000783,2115,776,333,443,18,18,497,190,307,812,756,56,12
2021,Richmond upon Thames 001,E02000784,4177,2377,1325,1052,8,8,686,169,517,1098,991,107,8
2021,Richmond upon Thames 002,E02000785,4163,2639,1418,1221,15,15,258,37,221,1247,1149,98,4
2021,Richmond upon Thames 003,E02000786,4944,2765,1214,1551,25,25,753,144,609,1398,1296,102,3
2021,Richmond upon Thames 004,E02000787,5173,2686,1118,1568,84,84,1023,180,843,1375,1280,95,5
2021,Richmond upon Thames 005,E02000788,3624,2440,1121,1319,3,3,265,36,229,915,842,73,1
2021,Richmond upon Thames 006,E02000789,2841,1431,763,668,7,7,521,32,489,880,805,75,2
2021,Richmond upon Thames 007,E02000790,2701,1774,743,1031,19,19,118,12,106,789,744,45,1
2021,Richmond upon Thames 008,E02000791,2969,1513,867,646,10,10,181,18,163,1264,1174,90,1
2021,Richmond upon Thames 009,E02000792,3101,1836,894,942,7,7,191,20,171,1067,989,78,0
2021,Richmond upon Thames 010,E02000793,3134,2158,1102,1056,22,22,335,47,288,619,544,75,0
2021,Richmond upon Thames 011,E02000794,2759,1956,874,1082,34,34,93,24,69,676,635,41,0
2021,Richmond upon Thames 012,E02000795,2590,1920,1033,887,8,8,225,39,186,433,369,64,4
2021,Richmond upon Thames 013,E02000796,3981,2495,1278,1217,25,25,838,201,637,617,562,55,6
2021,Richmond upon Thames 014,E02000797,3476,2035,865,1170,47,47,207,22,185,1186,1119,67,1
2021,Richmond upon Thames 015,E02000798,4325,3003,1260,1743,23,23,490,131,359,804,750,54,5
2021,Richmond upon Thames 016,E02000799,2440,1701,888,813,8,8,178,28,150,553,504,49,0
2021,Richmond upon Thames 017,E02000800,2156,1246,642,604,13,13,569,165,404,327,289,38,1
2021,Richmond upon Thames 018,E02000801,3018,2068,971,1097,38,38,185,15,170,726,678,48,1
2021,Richmond upon Thames 019,E02000802,2976,2083,981,1102,6,6,249,37,212,635,597,38,3
2021,Richmond upon Thames 020,E02000803,4095,2454,1258,1196,63,63,908,191,717,664,605,59,6
2021,Richmond upon Thames 021,E02000804,3168,1972,1007,965,22,22,327,58,269,847,783,64,0
2021,Richmond upon Thames 022,E02000805,4635,2857,1413,1444,43,43,630,109,521,1100,1016,84,5
2021,Richmond upon Thames 023,E02000806,4254,2950,1500,1450,33,33,519,112,407,747,670,77,5
2021,Southwark 001,E02000807,3735,1357,552,805,119,119,714,242,472,1543,1415,128,2
2021,Southwark 002,E02000808,4696,999,437,562,138,138,1465,740,725,2086,1895,191,8
2021,Southwark 004,E02000810,5393,1144,381,763,354,354,2447,1560,887,1443,1330,113,5
2021,Southwark 006,E02000812,4532,888,314,574,80,80,2246,1456,790,1309,1209,100,9
2021,Southwark 007,E02000813,4483,820,333,487,76,76,2109,1550,559,1470,1367,103,8
2021,Southwark 008,E02000814,4588,1491,565,926,140,140,1084,264,820,1869,1764,105,4
2021,Southwark 009,E02000815,3233,544,208,336,90,90,1050,748,302,1540,1443,97,9
2021,Southwark 010,E02000816,4149,972,315,657,147,147,1789,1210,579,1230,1159,71,11
2021,Southwark 011,E02000817,2925,497,155,342,46,46,1827,1309,518,545,517,28,10
2021,Southwark 012,E02000818,4488,981,280,701,247,247,1833,1098,735,1400,1320,80,27
2021,Southwark 013,E02000819,3556,535,207,328,65,65,2055,1293,762,891,813,78,10
2021,Southwark 014,E02000820,4228,945,352,593,125,125,1938,1499,439,1208,1097,111,12
2021,Southwark 015,E02000821,3134,443,156,287,119,119,1709,1403,306,858,783,75,5
2021,Southwark 016,E02000822,2775,356,129,227,16,16,1631,1371,260,760,721,39,12
2021,Southwark 017,E02000823,3634,822,322,500,65,65,1759,1471,288,977,888,89,11
2021,Southwark 018,E02000824,3791,626,203,423,53,53,2419,1995,424,652,589,63,41
2021,Southwark 019,E02000825,3891,634,138,496,83,83,2499,1731,768,658,578,80,17
2021,Southwark 020,E02000826,4023,1070,267,803,163,163,1876,1378,498,886,800,86,28
2021,Southwark 021,E02000827,5018,1041,293,748,145,145,2766,1755,1011,1050,962,88,16
2021,Southwark 022,E02000828,3596,777,230,547,155,155,1758,1389,369,888,826,62,18
2021,Southwark 023,E02000829,4739,1399,426,973,88,88,2275,1544,731,959,879,80,18
2021,Southwark 024,E02000830,3765,1555,603,952,40,40,984,645,339,1141,1006,135,45
2021,Southwark 025,E02000831,4053,1569,590,979,113,113,1226,638,588,1142,1070,72,3
2021,Southwark 026,E02000832,4099,1281,419,862,68,68,1932,1277,655,806,712,94,12
2021,Southwark 027,E02000833,3046,1062,360,702,28,28,1390,1246,144,558,498,60,8
2021,Southwark 028,E02000834,4102,1867,663,1204,23,23,843,322,521,1360,1282,78,9
2021,Southwark 029,E02000835,3028,1569,539,1030,17,17,821,605,216,614,568,46,7
2021,Southwark 030,E02000836,3337,1924,723,1201,18,18,547,299,248,844,774,70,4
2021,Southwark 031,E02000837,3150,2158,1086,1072,11,11,384,271,113,594,528,66,3
2021,Southwark 032,E02000838,3925,1960,698,1262,27,27,870,442,428,1061,961,100,7
2021,Southwark 033,E02000839,3429,1792,839,953,53,53,828,736,92,750,661,89,6
2021,Sutton 001,E02000840,3475,1608,435,1173,30,30,1412,927,485,415,375,40,10
2021,Sutton 002,E02000841,3304,1491,500,991,53,53,1275,969,306,478,438,40,7
2021,Sutton 003,E02000842,2958,2344,1144,1200,11,11,131,41,90,472,415,57,0
2021,Sutton 004,E02000843,3981,2491,790,1701,208,208,472,189,283,809,762,47,1
2021,Sutton 005,E02000844,3217,2033,760,1273,18,18,750,388,362,411,359,52,5
2021,Sutton 006,E02000845,3610,2521,1031,1490,37,37,300,87,213,752,681,71,0
2021,Sutton 007,E02000846,2787,2118,966,1152,23,23,177,77,100,467,429,38,2
2021,Sutton 008,E02000847,3683,2932,1441,1491,13,13,174,35,139,564,496,68,0
2021,Sutton 009,E02000848,2911,2468,1121,1347,6,6,65,34,31,372,340,32,0
2021,Sutton 010,E02000849,3254,2088,906,1182,34,34,563,268,295,563,511,52,6
2021,Sutton 011,E02000850,4091,3170,1344,1826,12,12,366,200,166,543,480,63,0
2021,Sutton 012,E02000851,5038,2001,804,1197,185,185,1093,640,453,1750,1662,88,9
2021,Sutton 013,E02000852,3249,2295,987,1308,13,13,185,50,135,753,701,52,3
2021,Sutton 014,E02000853,3205,2145,865,1280,15,15,358,184,174,684,640,44,3
2021,Sutton 015,E02000854,3086,2201,1022,1179,18,18,272,86,186,592,538,54,3
2021,Sutton 016,E02000855,3210,2478,1323,1155,14,14,142,49,93,574,510,64,2
2021,Sutton 017,E02000856,3800,2526,1122,1404,25,25,275,60,215,972,897,75,2
2021,Sutton 018,E02000857,4078,1931,938,993,13,13,326,120,206,1807,1729,78,1
2021,Sutton 019,E02000858,3309,1148,415,733,87,87,1676,273,1403,393,356,37,5
2021,Sutton 020,E02000859,3495,2427,1281,1146,8,8,470,151,319,589,524,65,1
2021,Sutton 021,E02000860,4119,1560,659,901,14,14,818,314,504,1723,1630,93,4
2021,Sutton 022,E02000861,2863,2478,1305,1173,8,8,83,56,27,294,269,25,0
2021,Sutton 024,E02000863,2422,1992,926,1066,9,9,206,170,36,214,183,31,1
2021,Tower Hamlets 001,E02000864,4664,1318,321,997,204,204,2030,572,1458,1107,1021,86,5
2021,Tower Hamlets 002,E02000865,2894,530,179,351,75,75,1489,763,726,789,741,48,11
2021,Tower Hamlets 003,E02000866,4153,1401,550,851,55,55,1420,300,1120,1265,1172,93,12
2021,Tower Hamlets 004,E02000867,4871,1319,328,991,211,211,1475,534,941,1855,1739,116,11
2021,Tower Hamlets 005,E02000868,2786,719,250,469,43,43,977,407,570,1043,983,60,4
2021,Tower Hamlets 006,E02000869,2524,626,302,324,31,31,1135,687,448,720,664,56,12
2021,Tower Hamlets 007,E02000870,2421,582,220,362,33,33,1054,591,463,747,694,53,5
2021,Tower Hamlets 008,E02000871,4228,816,238,578,197,197,1942,496,1446,1262,1180,82,11
2021,Tower Hamlets 009,E02000872,3192,614,229,385,56,56,1243,788,455,1270,1210,60,9
2021,Tower Hamlets 010,E02000873,2924,729,224,505,107,107,1244,881,363,830,779,51,14
2021,Tower Hamlets 011,E02000874,2524,470,149,321,40,40,1201,733,468,800,742,58,13
2021,Tower Hamlets 012,E02000875,5079,1004,271,733,161,161,2341,778,1563,1567,1453,114,6
2021,Tower Hamlets 013,E02000876,2778,584,209,375,34,34,973,467,506,1176,1065,111,11
2021,Tower Hamlets 014,E02000877,4913,1288,282,1006,98,98,2087,632,1455,1432,1325,107,8
2021,Tower Hamlets 015,E02000878,4012,831,355,476,63,63,1201,440,761,1907,1782,125,10
2021,Tower Hamlets 016,E02000879,3049,682,280,402,40,40,1386,463,923,934,850,84,7
2021,Tower Hamlets 017,E02000880,2281,470,186,284,23,23,849,627,222,932,900,32,7
2021,Tower Hamlets 018,E02000881,3854,757,251,506,149,149,1709,525,1184,1230,1164,66,9
2021,Tower Hamlets 019,E02000882,3813,582,170,412,252,252,2106,786,1320,864,794,70,9
2021,Tower Hamlets 020,E02000883,3030,573,153,420,77,77,1493,475,1018,881,831,50,6
2021,Tower Hamlets 021,E02000884,5114,808,339,469,186,186,1290,372,918,2826,2676,150,4
2021,Tower Hamlets 022,E02000885,2391,361,145,216,39,39,1326,477,849,649,601,48,16
2021,Tower Hamlets 023,E02000886,3824,1014,315,699,79,79,1132,699,433,1589,1493,96,10
2021,Tower Hamlets 024,E02000887,3948,748,260,488,98,98,1790,983,807,1296,1209,87,16
2021,Tower Hamlets 025,E02000888,3353,911,302,609,107,107,1040,467,573,1279,1204,75,16
2021,Tower Hamlets 026,E02000889,3807,976,368,608,82,82,903,403,500,1840,1698,142,6
2021,Tower Hamlets 027,E02000890,2891,1124,482,642,35,35,384,233,151,1346,1238,108,2
2021,Tower Hamlets 030,E02000893,2988,848,283,565,35,35,1092,231,861,1005,936,69,8
2021,Tower Hamlets 031,E02000894,4463,1326,442,884,85,85,942,182,760,2100,2001,99,10
2021,Waltham Forest 001,E02000895,3279,2105,1096,1009,36,36,731,377,354,404,351,53,3
2021,Waltham Forest 002,E02000896,3835,2661,1380,1281,19,19,375,165,210,777,715,62,3
2021,Waltham Forest 003,E02000897,3370,1941,883,1058,10,10,984,804,180,431,383,48,4
2021,Waltham Forest 004,E02000898,3203,1994,957,1037,32,32,748,322,426,425,381,44,4
2021,Waltham Forest 005,E02000899,3228,2180,1071,1109,13,13,397,228,169,637,564,73,1
2021,Waltham Forest 006,E02000900,3118,1870,833,1037,31,31,633,228,405,581,522,59,3
2021,Waltham Forest 007,E02000901,3850,2618,1102,1516,47,47,464,324,140,719,654,65,2
2021,Waltham Forest 008,E02000902,3518,1881,731,1150,155,155,764,399,365,712,649,63,6
2021,Waltham Forest 009,E02000903,3467,1517,499,1018,77,77,1206,795,411,658,604,54,9
2021,Waltham Forest 010,E02000904,3108,1823,683,1140,71,71,436,110,326,778,732,46,0
2021,Waltham Forest 011,E02000905,3630,1965,675,1290,48,48,667,253,414,946,875,71,4
2021,Waltham Forest 012,E02000906,3627,1785,627,1158,26,26,828,371,457,985,905,80,3
2021,Waltham Forest 013,E02000907,4067,1332,443,889,61,61,1739,1299,440,919,812,107,16
2021,Waltham Forest 014,E02000908,5239,2007,626,1381,260,260,1135,401,734,1832,1731,101,5
2021,Waltham Forest 015,E02000909,3568,1893,695,1198,38,38,686,410,276,946,878,68,5
2021,Waltham Forest 016,E02000910,4404,2002,848,1154,46,46,624,286,338,1725,1630,95,7
2021,Waltham Forest 017,E02000911,4848,1887,710,1177,141,141,965,526,439,1848,1747,101,7
2021,Waltham Forest 018,E02000912,3270,1631,652,979,55,55,758,341,417,820,740,80,6
2021,Waltham Forest 019,E02000913,3116,1770,884,886,51,51,408,88,320,883,819,64,4
2021,Waltham Forest 020,E02000914,3972,1316,537,779,85,85,1323,517,806,1236,1127,109,12
2021,Waltham Forest 021,E02000915,3283,1563,677,886,10,10,557,100,457,1152,1084,68,1
2021,Waltham Forest 022,E02000916,3982,1866,639,1227,115,115,563,209,354,1429,1274,155,9
2021,Waltham Forest 023,E02000917,3648,1706,563,1143,36,36,471,121,350,1434,1350,84,1
2021,Waltham Forest 024,E02000918,3407,1378,586,792,38,38,886,559,327,1099,966,133,6
2021,Waltham Forest 025,E02000919,3359,1486,655,831,21,21,408,142,266,1437,1348,89,7
2021,Waltham Forest 026,E02000920,3815,1316,579,737,107,107,1129,210,919,1256,1150,106,7
2021,Waltham Forest 027,E02000921,4059,1188,475,713,48,48,1546,781,765,1265,1196,69,12
2021,Waltham Forest 028,E02000922,3635,1675,711,964,22,22,671,375,296,1260,1172,88,7
2021,Wandsworth 001,E02000923,3469,1562,925,637,57,57,460,327,133,1387,1248,139,3
2021,Wandsworth 003,E02000925,3363,963,461,502,40,40,1477,1349,128,874,803,71,9
2021,Wandsworth 004,E02000926,5551,2004,794,1210,296,296,967,468,499,2283,2103,180,1
2021,Wandsworth 005,E02000927,3232,991,399,592,16,16,1234,366,868,988,913,75,3
2021,Wandsworth 006,E02000928,3614,2017,967,1050,16,16,364,241,123,1212,1144,68,5
2021,Wandsworth 007,E02000929,3495,722,283,439,99,99,1835,1563,272,827,771,56,12
2021,Wandsworth 008,E02000930,4261,1641,748,893,19,19,694,442,252,1904,1749,155,3
2021,Wandsworth 009,E02000931,3486,1847,691,1156,8,8,294,52,242,1337,1230,107,0
2021,Wandsworth 010,E02000932,5930,2544,997,1547,283,283,493,177,316,2608,2429,179,2
2021,Wandsworth 011,E02000933,3928,2091,1069,1022,37,37,397,279,118,1393,1259,134,10
2021,Wandsworth 012,E02000934,4196,1576,572,1004,79,79,761,167,594,1777,1658,119,3
2021,Wandsworth 013,E02000935,2434,518,291,227,15,15,1367,1229,138,518,423,95,16
2021,Wandsworth 014,E02000936,4381,1813,866,947,111,111,558,387,171,1887,1748,139,12
2021,Wandsworth 015,E02000937,3127,1692,680,1012,14,14,380,139,241,1040,971,69,1
2021,Wandsworth 016,E02000938,4345,1853,835,1018,152,152,1266,1123,143,1059,978,81,15
2021,Wandsworth 017,E02000939,2836,1840,833,1007,9,9,317,122,195,669,609,60,1
2021,Wandsworth 018,E02000940,4214,1499,446,1053,124,124,992,672,320,1595,1516,79,4
2021,Wandsworth 019,E02000941,4136,2234,763,1471,29,29,586,211,375,1285,1205,80,2
2021,Wandsworth 020,E02000942,3815,2287,1026,1261,26,26,230,155,75,1270,1133,137,2
2021,Wandsworth 021,E02000943,3809,1770,698,1072,55,55,438,210,228,1546,1473,73,0
2021,Wandsworth 022,E02000944,2889,886,360,526,43,43,983,848,135,973,900,73,4
2021,Wandsworth 023,E02000945,2760,787,367,420,29,29,1151,967,184,788,695,93,5
2021,Wandsworth 024,E02000946,3107,1406,458,948,51,51,597,426,171,1048,968,80,5
2021,Wandsworth 025,E02000947,3920,2182,775,1407,67,67,339,135,204,1330,1267,63,2
2021,Wandsworth 026,E02000948,4381,2075,758,1317,33,33,520,173,347,1747,1645,102,6
2021,Wandsworth 027,E02000949,4253,2347,995,1352,57,57,284,81,203,1565,1473,92,0
2021,Wandsworth 028,E02000950,3107,1415,665,750,16,16,523,477,46,1146,1077,69,7
2021,Wandsworth 029,E02000951,2823,1253,518,735,17,17,403,101,302,1150,1068,82,0
2021,Wandsworth 030,E02000952,2658,1105,439,666,8,8,564,137,427,979,926,53,2
2021,Wandsworth 031,E02000953,3209,1453,448,1005,73,73,659,236,423,1021,943,78,3
2021,Wandsworth 032,E02000954,2250,1220,580,640,23,23,258,163,95,748,707,41,1
2021,Wandsworth 033,E02000955,2676,1094,529,565,17,17,598,507,91,960,897,63,7
2021,Wandsworth 034,E02000956,3032,936,363,573,32,32,650,416,234,1402,1328,74,12
2021,Wandsworth 035,E02000957,4421,1751,699,1052,87,87,650,219,431,1928,1807,121,5
2021,Wandsworth 036,E02000958,2917,1761,811,950,12,12,437,292,145,704,651,53,3
2021,Wandsworth 037,E02000959,3104,1282,451,831,33,33,627,288,339,1161,1095,66,1
2021,Westminster 001,E02000960,2782,1075,707,368,12,12,360,262,98,1331,1202,129,4
2021,Westminster 002,E02000961,4068,1360,762,598,11,11,937,585,352,1748,1621,127,12
2021,Westminster 003,E02000962,3859,1096,698,398,14,14,797,406,391,1940,1755,185,12
2021,Westminster 004,E02000963,4135,888,397,491,46,46,2311,1572,739,872,801,71,18
2021,Westminster 005,E02000964,5358,1084,423,661,47,47,2613,610,2003,1599,1478,121,15
2021,Westminster 006,E02000965,3623,1226,537,689,15,15,625,192,433,1751,1642,109,6
2021,Westminster 007,E02000966,4113,1642,887,755,11,11,540,154,386,1917,1762,155,3
2021,Westminster 008,E02000967,3014,1134,716,418,22,22,197,91,106,1657,1492,165,4
2021,Westminster 009,E02000968,5617,787,472,315,38,38,3248,2254,994,1471,1385,86,73
2021,Westminster 010,E02000969,3720,595,302,293,66,66,2154,1407,747,872,798,74,33
2021,Westminster 011,E02000970,3555,1114,731,383,14,14,386,74,312,2039,1782,257,2
2021,Westminster 012,E02000971,3720,1020,628,392,28,28,371,99,272,2299,2142,157,2
2021,Westminster 013,E02000972,4257,812,507,305,41,41,1183,381,802,2207,1983,224,14
2021,Westminster 014,E02000973,4797,1524,870,654,29,29,1154,426,728,2086,1915,171,4
2021,Westminster 015,E02000974,3981,1142,728,414,53,53,650,137,513,2133,1895,238,3
2021,Westminster 016,E02000975,3802,1108,641,467,23,23,351,150,201,2311,2178,133,9
2021,Westminster 017,E02000976,4214,1169,707,462,11,11,564,405,159,2455,2257,198,15
2021,Westminster 018,E02000977,3432,815,561,254,13,13,821,205,616,1781,1481,300,2
2021,Westminster 019,E02000978,2764,1358,957,401,14,14,87,33,54,1303,1035,268,2
2021,Westminster 020,E02000979,3927,1057,676,381,27,27,1134,107,1027,1708,1360,348,1
2021,Westminster 021,E02000980,4324,1100,665,435,53,53,1847,1177,670,1308,1121,187,16
2021,Westminster 022,E02000981,4157,1269,694,575,34,34,1141,105,1036,1711,1487,224,2
2021,Westminster 023,E02000982,3844,793,467,326,58,58,1824,808,1016,1155,1002,153,14
2021,Westminster 024,E02000983,3760,794,484,310,19,19,1517,780,737,1412,1297,115,18
2021,Bolton 001,E02000984,3208,2830,1522,1308,5,5,38,17,21,335,294,41,0
2021,Bolton 002,E02000985,3222,2752,1660,1092,21,21,144,33,111,303,256,47,2
2021,Bolton 003,E02000986,3647,2832,1517,1315,11,11,193,86,107,610,528,82,1
2021,Bolton 004,E02000987,3460,2010,1054,956,25,25,741,348,393,678,607,71,6
2021,Bolton 005,E02000988,3639,2001,1099,902,4,4,854,498,356,772,687,85,8
2021,Bolton 006,E02000989,3744,3197,1925,1272,13,13,240,98,142,294,232,62,0
2021,Bolton 007,E02000990,3690,2702,1417,1285,7,7,328,132,196,650,583,67,3
2021,Bolton 008,E02000991,3250,2477,1306,1171,10,10,212,74,138,549,469,80,2
2021,Bolton 009,E02000992,2760,2125,1113,1012,7,7,221,146,75,405,346,59,2
2021,Bolton 010,E02000993,3450,1318,486,832,11,11,1447,966,481,663,615,48,11
2021,Bolton 011,E02000994,3317,1248,732,516,11,11,1242,610,632,804,716,88,12
2021,Bolton 012,E02000995,3424,2323,1344,979,7,7,693,461,232,393,332,61,8
2021,Bolton 013,E02000996,3382,1287,673,614,1,1,1755,1219,536,320,272,48,19
2021,Bolton 014,E02000997,2722,1938,985,953,8,8,437,196,241,336,301,35,3
2021,Bolton 015,E02000998,3702,1613,887,726,4,4,607,272,335,1465,1356,109,13
2021,Bolton 016,E02000999,3637,726,446,280,12,12,1996,1017,979,863,749,114,40
2021,Bolton 017,E02001000,4065,2224,1193,1031,8,8,630,209,421,1195,1062,133,8
2021,Bolton 018,E02001001,3207,2061,1154,907,14,14,291,177,114,835,729,106,6
2021,Bolton 019,E02001002,4073,2688,1433,1255,18,18,884,420,464,479,407,72,4
2021,Bolton 020,E02001003,2829,2477,1544,933,11,11,56,16,40,284,237,47,1
2021,Bolton 021,E02001004,3059,1173,836,337,7,7,1157,723,434,700,617,83,22
2021,Bolton 022,E02001005,3389,1426,770,656,24,24,845,355,490,1077,972,105,17
2021,Bolton 023,E02001006,2759,1516,927,589,18,18,401,153,248,811,695,116,13
2021,Bolton 024,E02001007,4393,3308,1905,1403,14,14,511,280,231,550,457,93,10
2021,Bolton 025,E02001008,2832,1171,689,482,17,17,1064,591,473,565,491,74,15
2021,Bolton 026,E02001009,2977,1603,846,757,13,13,758,242,516,593,485,108,10
2021,Bolton 027,E02001010,2487,1296,643,653,28,28,504,225,279,656,583,73,3
2021,Bolton 028,E02001011,4232,3378,1814,1564,43,43,242,72,170,569,492,77,0
2021,Bolton 029,E02001012,2980,1997,897,1100,5,5,539,419,120,434,379,55,5
2021,Bolton 030,E02001013,2496,2027,1138,889,16,16,166,81,85,285,239,46,2
2021,Bolton 031,E02001014,3785,2247,1094,1153,12,12,942,478,464,577,520,57,7
2021,Bolton 032,E02001015,3860,1877,959,918,22,22,1144,537,607,808,716,92,9
2021,Bolton 033,E02001016,3341,1500,634,866,40,40,1327,870,457,462,418,44,12
2021,Bolton 034,E02001017,4661,3155,1613,1542,12,12,723,455,268,757,682,75,14
2021,Bolton 035,E02001018,3109,2579,1220,1359,14,14,224,62,162,291,251,40,1
2021,Bury 001,E02001019,4073,2817,1407,1410,9,9,482,264,218,763,674,89,2
2021,Bury 002,E02001020,2508,2209,1402,807,4,4,105,89,16,189,159,30,1
2021,Bury 003,E02001021,3177,2664,1374,1290,10,10,115,80,35,386,322,64,2
2021,Bury 004,E02001022,3367,2395,1306,1089,28,28,432,329,103,506,429,77,6
2021,Bury 005,E02001023,2324,1689,952,737,0,0,364,274,90,262,233,29,9
2021,Bury 006,E02001024,3377,2791,1438,1353,4,4,172,118,54,408,346,62,2
2021,Bury 007,E02001025,3425,1593,801,792,26,26,1300,990,310,485,418,67,21
2021,Bury 008,E02001026,4377,1919,887,1032,10,10,776,253,523,1665,1510,155,7
2021,Bury 009,E02001027,3177,1912,833,1079,8,8,402,275,127,846,764,82,9
2021,Bury 010,E02001028,3099,2769,1754,1015,5,5,138,54,84,187,141,46,0
2021,Bury 011,E02001029,2876,1631,812,819,7,7,642,236,406,592,510,82,4
2021,Bury 012,E02001030,2511,2120,1064,1056,9,9,176,103,73,206,176,30,0
2021,Bury 013,E02001031,2951,1762,885,877,26,26,628,285,343,532,480,52,3
2021,Bury 014,E02001032,3278,2368,1218,1150,10,10,297,226,71,598,513,85,5
2021,Bury 015,E02001033,2684,1655,711,944,6,6,397,173,224,623,539,84,3
2021,Bury 016,E02001034,4087,1480,679,801,36,36,1554,791,763,999,932,67,18
2021,Bury 017,E02001035,2993,2551,1463,1088,10,10,119,66,53,313,268,45,0
2021,Bury 018,E02001036,3093,2017,959,1058,6,6,461,393,68,601,539,62,8
2021,Bury 019,E02001037,3035,2540,1457,1083,10,10,76,35,41,409,345,64,0
2021,Bury 020,E02001038,2675,1573,746,827,15,15,538,391,147,542,493,49,7
2021,Bury 021,E02001039,3513,1857,856,1001,14,14,1118,354,764,523,479,44,1
2021,Bury 022,E02001040,2632,2120,1100,1020,6,6,99,71,28,402,349,53,5
2021,Bury 023,E02001041,3400,2127,1021,1106,15,15,638,432,206,616,568,48,4
2021,Bury 024,E02001042,2892,1811,931,880,4,4,440,112,328,636,580,56,1
2021,Bury 025,E02001043,2374,1621,754,867,6,6,431,237,194,312,277,35,4
2021,Bury 026,E02001044,2794,2001,942,1059,7,7,144,87,57,642,577,65,0
2021,Manchester 001,E02001045,3607,1500,779,721,12,12,1526,973,553,552,489,63,17
2021,Manchester 002,E02001046,4379,1983,779,1204,75,75,1455,1019,436,844,767,77,22
2021,Manchester 003,E02001047,4360,1771,792,979,11,11,1786,1305,481,773,716,57,19
2021,Manchester 004,E02001048,3486,1797,940,857,14,14,573,285,288,1097,1017,80,5
2021,Manchester 005,E02001049,4205,2612,1384,1228,17,17,914,584,330,652,577,75,10
2021,Manchester 006,E02001050,3162,1145,563,582,26,26,805,492,313,1176,1110,66,10
2021,Manchester 007,E02001051,3524,1730,874,856,8,8,620,312,308,1154,1055,99,12
2021,Manchester 008,E02001052,4412,1687,873,814,75,75,745,150,595,1901,1753,148,4
2021,Manchester 009,E02001053,4587,954,426,528,30,30,2612,1611,1001,970,883,87,21
2021,Manchester 011,E02001055,3986,1505,722,783,16,16,1450,918,532,1004,937,67,11
2021,Manchester 012,E02001056,3445,862,432,430,24,24,1883,872,1011,666,596,70,10
2021,Manchester 015,E02001059,4799,1250,525,725,45,45,1955,600,1355,1540,1463,77,9
2021,Manchester 017,E02001061,4322,1513,648,865,61,61,1631,429,1202,1106,991,115,11
2021,Manchester 018,E02001062,3572,790,272,518,9,9,1982,873,1109,781,707,74,10
2021,Manchester 019,E02001063,3464,600,237,363,8,8,1357,304,1053,1495,1408,87,4
2021,Manchester 020,E02001064,3909,1268,493,775,17,17,1697,651,1046,916,808,108,11
2021,Manchester 021,E02001065,3844,1629,854,775,63,63,728,192,536,1409,1313,96,15
2021,Manchester 022,E02001066,3449,749,370,379,10,10,808,184,624,1876,1796,80,6
2021,Manchester 023,E02001067,4121,1051,355,696,76,76,1909,610,1299,1070,999,71,15
2021,Manchester 024,E02001068,4121,720,331,389,35,35,2271,617,1654,1083,1010,73,12
2021,Manchester 025,E02001069,4303,1073,470,603,34,34,1311,287,1024,1875,1762,113,10
2021,Manchester 026,E02001070,3139,899,443,456,9,9,727,251,476,1500,1402,98,4
2021,Manchester 028,E02001072,3899,1447,632,815,20,20,784,107,677,1644,1565,79,4
2021,Manchester 029,E02001073,3986,2355,1132,1223,6,6,360,28,332,1263,1181,82,2
2021,Manchester 030,E02001074,4224,1716,793,923,28,28,1389,567,822,1057,978,79,34
2021,Manchester 031,E02001075,3452,1506,611,895,46,46,519,88,431,1380,1284,96,1
2021,Manchester 032,E02001076,2797,723,364,359,11,11,270,73,197,1785,1722,63,8
2021,Manchester 033,E02001077,3043,1879,891,988,13,13,269,33,236,881,830,51,1
2021,Manchester 034,E02001078,3800,2363,1144,1219,34,34,524,97,427,876,769,107,3
2021,Manchester 035,E02001079,3446,1201,492,709,50,50,1277,374,903,909,847,62,9
2021,Manchester 036,E02001080,3425,1055,526,529,14,14,539,104,435,1817,1750,67,0
2021,Manchester 037,E02001081,2800,1762,739,1023,17,17,440,71,369,579,537,42,2
2021,Manchester 038,E02001082,2901,1196,514,682,12,12,331,89,242,1359,1301,58,3
2021,Manchester 039,E02001083,4079,1625,496,1129,34,34,562,135,427,1857,1789,68,1
2021,Manchester 040,E02001084,3330,1639,749,890,13,13,598,172,426,1077,1024,53,3
2021,Manchester 041,E02001085,3204,1262,466,796,45,45,1515,533,982,376,345,31,6
2021,Manchester 042,E02001086,2951,1376,573,803,13,13,825,200,625,733,694,39,4
2021,Manchester 043,E02001087,4338,2575,1255,1320,14,14,463,72,391,1281,1215,66,5
2021,Manchester 044,E02001088,3786,1677,696,981,21,21,1519,642,877,564,508,56,5
2021,Manchester 045,E02001089,3203,2376,1162,1214,33,33,148,21,127,646,588,58,0
2021,Manchester 046,E02001090,3138,1975,952,1023,18,18,564,154,410,578,523,55,3
2021,Manchester 047,E02001091,3880,2119,990,1129,34,34,1132,345,787,587,512,75,8
2021,Manchester 048,E02001092,3851,1660,685,975,51,51,1537,651,886,597,550,47,6
2021,Manchester 049,E02001093,3918,1257,483,774,34,34,1855,631,1224,762,717,45,10
2021,Manchester 050,E02001094,3943,749,352,397,80,80,2605,893,1712,498,453,45,11
2021,Manchester 051,E02001095,3738,1323,585,738,78,78,1809,704,1105,523,465,58,5
2021,Manchester 052,E02001096,3426,1667,808,859,25,25,1283,471,812,449,395,54,2
2021,Manchester 053,E02001097,3527,1309,586,723,39,39,1590,625,965,584,539,45,5
2021,Oldham 001,E02001098,2728,1981,1253,728,12,12,392,216,176,342,282,60,1
2021,Oldham 002,E02001099,2652,1586,836,750,21,21,491,143,348,551,491,60,3
2021,Oldham 003,E02001100,2590,1860,1034,826,4,4,333,170,163,391,332,59,2
2021,Oldham 004,E02001101,2449,1998,1152,846,3,3,184,100,84,263,209,54,1
2021,Oldham 005,E02001102,2527,1991,982,1009,9,9,129,76,53,395,342,53,3
2021,Oldham 006,E02001103,2427,1866,1095,771,18,18,245,75,170,297,228,69,1
2021,Oldham 007,E02001104,2843,1937,811,1126,15,15,531,281,250,355,285,70,5
2021,Oldham 008,E02001105,2675,1784,1005,779,36,36,563,260,303,290,244,46,2
2021,Oldham 009,E02001106,2746,1732,888,844,3,3,498,131,367,512,439,73,1
2021,Oldham 010,E02001107,2561,1708,864,844,5,5,398,179,219,442,395,47,8
2021,Oldham 011,E02001108,2356,1003,447,556,16,16,808,391,417,527,483,44,2
2021,Oldham 012,E02001109,3363,1700,768,932,32,32,1062,493,569,560,502,58,9
2021,Oldham 013,E02001110,2859,2357,1335,1022,12,12,62,17,45,428,373,55,0
2021,Oldham 014,E02001111,3436,688,313,375,45,45,2073,945,1128,608,524,84,22
2021,Oldham 015,E02001112,2451,2165,1196,969,7,7,39,13,26,237,191,46,3
2021,Oldham 016,E02001113,2512,1196,514,682,3,3,677,206,471,633,544,89,3
2021,Oldham 017,E02001114,3494,1985,958,1027,27,27,933,442,491,535,446,89,14
2021,Oldham 018,E02001115,2606,1766,892,874,7,7,389,191,198,440,380,60,4
2021,Oldham 019,E02001116,2387,1368,633,735,10,10,186,69,117,812,715,97,11
2021,Oldham 020,E02001117,2623,2057,1233,824,2,2,240,97,143,324,289,35,0
2021,Oldham 021,E02001118,2628,2052,1129,923,4,4,236,71,165,336,294,42,0
2021,Oldham 022,E02001119,2868,1569,958,611,7,7,622,161,461,666,529,137,4
2021,Oldham 024,E02001121,2462,1007,530,477,8,8,754,267,487,668,573,95,25
2021,Oldham 026,E02001123,2788,1323,607,716,11,11,1083,524,559,366,317,49,5
2021,Oldham 027,E02001124,2807,1100,538,562,24,24,983,369,614,688,631,57,12
2021,Oldham 028,E02001125,3338,2352,1177,1175,9,9,410,179,231,555,476,79,12
2021,Oldham 029,E02001126,3357,1337,549,788,17,17,1273,247,1026,719,632,87,11
2021,Oldham 030,E02001127,2942,1312,644,668,5,5,1255,242,1013,363,323,40,7
2021,Oldham 031,E02001128,3282,2016,1112,904,2,2,444,149,295,815,725,90,5
2021,Oldham 032,E02001129,3064,1452,624,828,4,4,780,224,556,822,742,80,6
2021,Oldham 033,E02001130,2588,1734,947,787,12,12,570,305,265,268,221,47,4
2021,Oldham 034,E02001131,2306,1755,958,797,5,5,269,105,164,277,238,39,0
2021,Rochdale 001,E02001132,3057,2023,1024,999,9,9,328,193,135,697,610,87,0
2021,Rochdale 002,E02001133,2737,2181,1095,1086,5,5,180,101,79,369,301,68,2
2021,Rochdale 003,E02001134,2655,2140,1122,1018,9,9,108,73,35,398,334,64,0
2021,Rochdale 004,E02001135,3201,1358,560,798,41,41,1315,823,492,478,423,55,9
2021,Rochdale 005,E02001136,3739,2566,1356,1210,3,3,477,298,179,684,606,78,9
2021,Rochdale 006,E02001137,2616,2174,1113,1061,2,2,73,37,36,362,318,44,5
2021,Rochdale 007,E02001138,3647,2887,1650,1237,8,8,276,186,90,468,402,66,8
2021,Rochdale 008,E02001139,3247,1598,786,812,6,6,621,244,377,1018,940,78,4
2021,Rochdale 009,E02001140,3051,1724,829,895,9,9,642,406,236,662,579,83,14
2021,Rochdale 010,E02001141,4584,1621,886,735,20,20,1707,929,778,1204,1055,149,32
2021,Rochdale 011,E02001142,2428,2071,1285,786,5,5,78,42,36,270,236,34,4
2021,Rochdale 012,E02001143,4047,2069,939,1130,9,9,1151,592,559,810,709,101,8
2021,Rochdale 013,E02001144,2860,1817,902,915,5,5,510,302,208,526,472,54,2
2021,Rochdale 014,E02001145,3079,2186,1123,1063,9,9,370,220,150,512,452,60,2
2021,Rochdale 015,E02001146,3084,1443,892,551,9,9,627,178,449,992,875,117,13
2021,Rochdale 016,E02001147,4138,2093,837,1256,7,7,1501,1150,351,517,437,80,20
2021,Rochdale 017,E02001148,4385,2730,1405,1325,19,19,726,333,393,907,778,129,3
2021,Rochdale 018,E02001149,4815,2148,1038,1110,29,29,1503,818,685,1123,1022,101,12
2021,Rochdale 019,E02001150,3696,2036,978,1058,5,5,1194,390,804,455,397,58,6
2021,Rochdale 020,E02001151,4188,2977,1468,1509,24,24,398,205,193,785,690,95,4
2021,Rochdale 021,E02001152,4128,2353,1122,1231,54,54,996,663,333,719,651,68,6
2021,Rochdale 022,E02001153,4933,2151,852,1299,18,18,2126,668,1458,633,560,73,5
2021,Rochdale 023,E02001154,4385,2710,1255,1455,4,4,760,390,370,900,800,100,11
2021,Rochdale 024,E02001155,3447,2004,1056,948,17,17,753,464,289,663,596,67,10
2021,Rochdale 025,E02001156,4096,3323,1843,1480,17,17,400,271,129,356,294,62,0
2021,Salford 001,E02001157,3465,1123,534,589,34,34,1769,1019,750,516,475,41,23
2021,Salford 002,E02001158,2724,1256,636,620,2,2,908,554,354,547,485,62,11
2021,Salford 003,E02001159,3261,1715,661,1054,60,60,773,356,417,709,657,52,4
2021,Salford 004,E02001160,2864,1388,612,776,16,16,1099,673,426,352,319,33,9
2021,Salford 005,E02001161,2665,1638,901,737,8,8,465,203,262,551,504,47,3
2021,Salford 006,E02001162,2688,1590,924,666,8,8,552,293,259,532,487,45,6
2021,Salford 007,E02001163,4421,3023,1490,1533,21,21,563,271,292,809,725,84,5
2021,Salford 008,E02001164,2842,1489,601,888,29,29,831,436,395,481,427,54,12
2021,Salford 009,E02001165,2663,1660,769,891,1,1,493,280,213,504,439,65,5
2021,Salford 010,E02001166,2382,1063,545,518,10,10,498,141,357,806,742,64,5
2021,Salford 011,E02001167,2806,1375,675,700,14,14,545,312,233,869,799,70,3
2021,Salford 012,E02001168,4219,2482,1169,1313,17,17,976,483,493,719,644,75,25
2021,Salford 013,E02001169,4453,3804,1943,1861,19,19,171,91,80,457,392,65,2
2021,Salford 014,E02001170,4145,3462,1796,1666,11,11,186,69,117,484,410,74,2
2021,Salford 015,E02001171,2553,2078,1037,1041,18,18,119,26,93,337,290,47,1
2021,Salford 017,E02001173,3572,966,409,557,55,55,1517,745,772,1016,962,54,18
2021,Salford 018,E02001174,2339,1628,818,810,6,6,145,23,122,557,510,47,3
2021,Salford 019,E02001175,3077,1749,744,1005,19,19,792,427,365,509,458,51,8
2021,Salford 020,E02001176,5473,2978,1347,1631,25,25,1264,600,664,1183,1069,114,23
2021,Salford 021,E02001177,5814,2524,1176,1348,57,57,1537,590,947,1678,1532,146,18
2021,Salford 023,E02001179,3170,1283,671,612,35,35,693,160,533,1153,1081,72,6
2021,Salford 024,E02001180,2541,289,145,144,7,7,1804,858,946,418,381,37,23
2021,Salford 025,E02001181,2634,1086,504,582,12,12,1117,556,561,403,358,45,16
2021,Salford 026,E02001182,3327,1192,483,709,29,29,1449,684,765,646,596,50,11
2021,Salford 027,E02001183,3187,1461,627,834,37,37,728,331,397,954,864,90,7
2021,Salford 029,E02001185,4089,2668,1352,1316,4,4,870,436,434,542,466,76,5
2021,Salford 030,E02001186,4479,2694,1123,1571,10,10,989,596,393,775,670,105,11
2021,Stockport 001,E02001187,3081,2170,1091,1079,4,4,375,172,203,532,486,46,0
2021,Stockport 002,E02001188,3828,1952,805,1147,80,80,790,492,298,1002,944,58,4
2021,Stockport 003,E02001189,3594,2620,1307,1313,33,33,337,178,159,601,521,80,3
2021,Stockport 004,E02001190,3485,1172,427,745,60,60,1968,1649,319,279,253,26,6
2021,Stockport 005,E02001191,2632,1907,1046,861,37,37,471,282,189,213,179,34,4
2021,Stockport 006,E02001192,2858,1976,972,1004,10,10,229,87,142,643,593,50,0
2021,Stockport 007,E02001193,3014,1699,753,946,12,12,544,303,241,758,702,56,1
2021,Stockport 008,E02001194,2656,2042,1072,970,56,56,126,27,99,432,404,28,0
2021,Stockport 009,E02001195,3265,2556,1295,1261,61,61,151,87,64,497,439,58,0
2021,Stockport 010,E02001196,3424,2619,1535,1084,15,15,439,292,147,349,294,55,2
2021,Stockport 011,E02001197,2626,1964,978,986,13,13,346,225,121,301,246,55,2
2021,Stockport 012,E02001198,3347,2118,1201,917,41,41,838,310,528,344,297,47,6
2021,Stockport 013,E02001199,3402,2709,1418,1291,29,29,104,29,75,559,502,57,1
2021,Stockport 014,E02001200,4085,978,451,527,154,154,1780,1090,690,1163,1108,55,10
2021,Stockport 015,E02001201,2461,1868,824,1044,26,26,129,64,65,436,371,65,2
2021,Stockport 016,E02001202,3184,1474,577,897,40,40,635,399,236,1033,965,68,2
2021,Stockport 017,E02001203,2456,2212,1319,893,4,4,60,40,20,180,156,24,0
2021,Stockport 018,E02001204,3784,2734,1172,1562,39,39,420,265,155,587,528,59,4
2021,Stockport 019,E02001205,3971,2200,1025,1175,124,124,891,346,545,752,674,78,4
2021,Stockport 020,E02001206,3099,2428,1337,1091,33,33,337,195,142,300,266,34,1
2021,Stockport 021,E02001207,2936,2423,1316,1107,13,13,246,74,172,254,222,32,0
2021,Stockport 022,E02001208,3446,2318,1054,1264,8,8,574,239,335,544,489,55,2
2021,Stockport 023,E02001209,3440,2165,950,1215,69,69,416,256,160,783,715,68,7
2021,Stockport 024,E02001210,3043,1770,875,895,69,69,905,582,323,291,246,45,8
2021,Stockport 025,E02001211,2603,2197,1064,1133,9,9,116,29,87,281,236,45,0
2021,Stockport 026,E02001212,2683,1326,448,878,30,30,1040,718,322,283,253,30,4
2021,Stockport 027,E02001213,4278,3121,1466,1655,138,138,300,64,236,718,652,66,1
2021,Stockport 028,E02001214,3175,2403,1341,1062,15,15,411,331,80,342,287,55,4
2021,Stockport 029,E02001215,2630,2110,1218,892,40,40,237,142,95,240,197,43,3
2021,Stockport 030,E02001216,3325,2708,1502,1206,20,20,148,112,36,446,410,36,3
2021,Stockport 031,E02001217,3136,2090,1102,988,48,48,315,224,91,682,604,78,1
2021,Stockport 032,E02001218,2359,2001,1095,906,10,10,167,30,137,180,160,20,1
2021,Stockport 033,E02001219,2221,2026,1192,834,3,3,15,8,7,177,151,26,0
2021,Stockport 034,E02001220,2319,1809,944,865,19,19,287,139,148,203,177,26,1
2021,Stockport 035,E02001221,2386,2171,1251,920,15,15,63,33,30,137,118,19,0
2021,Stockport 036,E02001222,2418,2125,1172,953,14,14,61,18,43,218,171,47,0
2021,Stockport 037,E02001223,2796,2409,1403,1006,33,33,49,19,30,305,272,33,0
2021,Stockport 038,E02001224,2548,2303,1494,809,3,3,68,48,20,174,144,30,0
2021,Stockport 039,E02001225,3028,2538,1367,1171,17,17,140,105,35,332,284,48,1
2021,Stockport 040,E02001226,2784,2232,1145,1087,29,29,186,93,93,336,276,60,1
2021,Stockport 041,E02001227,2333,2151,1259,892,2,2,47,19,28,132,111,21,1
2021,Stockport 042,E02001228,2517,2233,1234,999,14,14,93,67,26,177,140,37,0
2021,Tameside 001,E02001229,4669,3250,1529,1721,10,10,445,117,328,961,859,102,3
2021,Tameside 002,E02001230,2346,1844,1128,716,0,0,217,65,152,284,239,45,1
2021,Tameside 003,E02001231,2863,1899,902,997,4,4,700,216,484,258,207,51,2
2021,Tameside 004,E02001232,3611,1902,999,903,12,12,847,286,561,840,767,73,10
2021,Tameside 005,E02001233,3375,1967,1049,918,18,18,962,293,669,425,356,69,3
2021,Tameside 006,E02001234,3261,1541,782,759,9,9,1047,348,699,661,613,48,3
2021,Tameside 007,E02001235,3057,1926,933,993,5,5,299,81,218,827,749,78,0
2021,Tameside 008,E02001236,2619,1111,545,566,12,12,991,342,649,496,421,75,9
2021,Tameside 009,E02001237,3089,1759,716,1043,6,6,709,215,494,610,559,51,5
2021,Tameside 010,E02001238,3539,2256,1173,1083,23,23,639,156,483,620,545,75,1
2021,Tameside 011,E02001239,3988,2406,1173,1233,7,7,667,184,483,899,824,75,9
2021,Tameside 012,E02001240,2632,1924,989,935,10,10,130,16,114,568,508,60,0
2021,Tameside 013,E02001241,4713,1252,605,647,5,5,2150,349,1801,1303,1191,112,3
2021,Tameside 014,E02001242,2888,2393,1175,1218,2,2,107,16,91,386,334,52,0
2021,Tameside 015,E02001243,3828,2459,1377,1082,22,22,613,157,456,731,636,95,3
2021,Tameside 016,E02001244,2302,1884,1100,784,4,4,111,44,67,302,259,43,1
2021,Tameside 017,E02001245,3623,1888,905,983,3,3,982,254,728,741,673,68,9
2021,Tameside 018,E02001246,3180,1659,810,849,5,5,1182,376,806,329,276,53,5
2021,Tameside 019,E02001247,3276,1926,886,1040,20,20,869,212,657,460,395,65,1
2021,Tameside 020,E02001248,5217,2777,1022,1755,14,14,1478,452,1026,941,847,94,7
2021,Tameside 021,E02001249,2921,1737,923,814,13,13,402,95,307,763,698,65,6
2021,Tameside 022,E02001250,2737,2224,1130,1094,15,15,190,53,137,308,266,42,0
2021,Tameside 023,E02001251,2835,2037,1104,933,19,19,329,93,236,450,390,60,0
2021,Tameside 024,E02001252,3282,2766,1503,1263,4,4,133,12,121,377,317,60,2
2021,Tameside 025,E02001253,2260,1599,854,745,3,3,237,56,181,418,351,67,3
2021,Tameside 026,E02001254,2491,1644,900,744,2,2,547,164,383,297,259,38,1
2021,Tameside 027,E02001255,3232,1431,515,916,2,2,1449,352,1097,342,304,38,8
2021,Tameside 028,E02001256,4174,2135,953,1182,23,23,972,201,771,1043,937,106,1
2021,Tameside 029,E02001257,4284,2335,1275,1060,34,34,1480,290,1190,429,371,58,6
2021,Tameside 030,E02001258,3234,2588,1408,1180,10,10,238,59,179,398,343,55,0
2021,Trafford 001,E02001259,4766,1506,788,718,42,42,1715,431,1284,1490,1409,81,13
2021,Trafford 002,E02001260,3076,2489,1262,1227,33,33,273,126,147,278,237,41,3
2021,Trafford 003,E02001261,3664,2116,838,1278,14,14,569,188,381,964,885,79,1
2021,Trafford 004,E02001262,3082,1901,975,926,18,18,671,200,471,489,425,64,3
2021,Trafford 005,E02001263,3408,2932,1585,1347,19,19,170,56,114,287,238,49,0
2021,Trafford 006,E02001264,3301,2503,1129,1374,35,35,386,131,255,377,322,55,0
2021,Trafford 007,E02001265,3388,2548,1240,1308,48,48,534,224,310,255,217,38,3
2021,Trafford 008,E02001266,3094,1730,847,883,40,40,977,289,688,345,306,39,2
2021,Trafford 009,E02001267,3389,2100,1004,1096,28,28,604,147,457,654,594,60,3
2021,Trafford 010,E02001268,2957,2456,1335,1121,32,32,234,75,159,234,196,38,1
2021,Trafford 011,E02001269,3574,2203,1034,1169,16,16,701,207,494,651,602,49,3
2021,Trafford 012,E02001270,3654,2490,1135,1355,31,31,355,104,251,776,713,63,2
2021,Trafford 013,E02001271,2787,1891,942,949,9,9,599,140,459,286,251,35,2
2021,Trafford 014,E02001272,3368,2658,1348,1310,5,5,195,43,152,509,463,46,1
2021,Trafford 015,E02001273,4349,2632,1297,1335,30,30,298,86,212,1388,1302,86,1
2021,Trafford 016,E02001274,3147,2700,1578,1122,7,7,151,53,98,286,258,28,3
2021,Trafford 017,E02001275,3346,1706,868,838,40,40,1217,198,1019,379,337,42,4
2021,Trafford 018,E02001276,3249,2133,989,1144,9,9,790,371,419,310,266,44,7
2021,Trafford 019,E02001277,3801,2051,839,1212,60,60,1226,212,1014,464,405,59,0
2021,Trafford 020,E02001278,3363,2673,1320,1353,32,32,209,32,177,449,402,47,0
2021,Trafford 021,E02001279,3166,2858,1463,1395,1,1,87,12,75,220,192,28,0
2021,Trafford 022,E02001280,3512,2117,1120,997,25,25,1027,285,742,337,280,57,6
2021,Trafford 023,E02001281,3074,2736,1505,1231,19,19,87,17,70,232,200,32,0
2021,Trafford 024,E02001282,4222,2896,1259,1637,8,8,332,112,220,985,916,69,1
2021,Trafford 025,E02001283,4092,2799,1451,1348,25,25,405,136,269,861,769,92,2
2021,Trafford 026,E02001284,3124,2552,1220,1332,9,9,114,31,83,449,398,51,0
2021,Trafford 027,E02001285,3259,2457,1353,1104,15,15,290,95,195,495,426,69,2
2021,Trafford 028,E02001286,3060,2557,1425,1132,5,5,202,63,139,293,245,48,3
2021,Wigan 001,E02001287,2800,2316,1090,1226,47,47,163,98,65,273,233,40,1
2021,Wigan 002,E02001288,3618,2876,1508,1368,13,13,348,302,46,374,320,54,7
2021,Wigan 003,E02001289,4446,3753,2217,1536,6,6,237,198,39,445,378,67,5
2021,Wigan 004,E02001290,2688,1957,1127,830,2,2,434,387,47,287,240,47,8
2021,Wigan 005,E02001291,3330,1946,1049,897,5,5,832,738,94,522,452,70,25
2021,Wigan 006,E02001292,3688,2596,1523,1073,8,8,313,170,143,769,679,90,2
2021,Wigan 007,E02001293,2673,2075,1178,897,7,7,327,235,92,262,225,37,2
2021,Wigan 008,E02001294,3682,2262,1206,1056,4,4,358,92,266,1048,949,99,10
2021,Wigan 009,E02001295,3544,1175,621,554,9,9,1673,1383,290,654,586,68,33
2021,Wigan 010,E02001296,3599,984,433,551,1,1,2152,2069,83,428,385,43,34
2021,Wigan 011,E02001297,2926,1748,882,866,3,3,725,597,128,434,376,58,16
2021,Wigan 012,E02001298,3363,1528,770,758,7,7,1163,979,184,650,577,73,15
2021,Wigan 013,E02001299,3876,2613,1312,1301,8,8,535,459,76,715,620,95,5
2021,Wigan 014,E02001300,3507,2216,1160,1056,17,17,527,396,131,738,653,85,9
2021,Wigan 015,E02001301,4082,2022,855,1167,16,16,1027,661,366,1007,926,81,10
2021,Wigan 016,E02001302,3361,1996,1051,945,4,4,990,826,164,357,312,45,14
2021,Wigan 017,E02001303,3870,1826,841,985,10,10,1567,1507,60,439,397,42,28
2021,Wigan 018,E02001304,5610,4547,2431,2116,20,20,461,431,30,578,479,99,4
2021,Wigan 019,E02001305,3640,3014,1623,1391,8,8,233,201,32,385,333,52,0
2021,Wigan 020,E02001306,3028,2464,1439,1025,9,9,279,227,52,270,212,58,6
2021,Wigan 021,E02001307,4615,4263,2104,2159,8,8,49,29,20,295,234,61,0
2021,Wigan 022,E02001308,2717,1903,1051,852,18,18,337,294,43,446,393,53,13
2021,Wigan 023,E02001309,3828,2572,1216,1356,15,15,353,250,103,884,795,89,4
2021,Wigan 024,E02001310,3916,2157,991,1166,6,6,812,583,229,928,846,82,13
2021,Wigan 025,E02001311,3724,2330,1246,1084,17,17,612,545,67,757,656,101,8
2021,Wigan 026,E02001312,3427,2231,1094,1137,35,35,457,376,81,698,622,76,6
2021,Wigan 027,E02001313,3510,1878,944,934,3,3,1107,975,132,509,445,64,13
2021,Wigan 028,E02001314,3224,2503,1210,1293,13,13,351,317,34,350,307,43,7
2021,Wigan 029,E02001315,4007,3170,1445,1725,103,103,331,307,24,399,336,63,4
2021,Wigan 030,E02001316,3494,1586,833,753,17,17,335,155,180,1553,1434,119,3
2021,Wigan 031,E02001317,3903,2595,1219,1376,20,20,807,714,93,475,426,49,6
2021,Wigan 032,E02001318,3398,2264,1303,961,6,6,735,706,29,376,317,59,17
2021,Wigan 033,E02001319,3666,2102,1007,1095,41,41,675,416,259,840,758,82,8
2021,Wigan 034,E02001320,3399,2153,1221,932,20,20,569,500,69,650,569,81,7
2021,Wigan 035,E02001321,3341,2574,1356,1218,10,10,281,263,18,467,396,71,9
2021,Wigan 036,E02001322,3184,2446,1413,1033,6,6,221,193,28,506,447,59,5
2021,Wigan 037,E02001323,3434,2299,1214,1085,18,18,631,476,155,477,414,63,9
2021,Wigan 038,E02001324,3602,2193,1107,1086,10,10,671,560,111,722,642,80,6
2021,Wigan 039,E02001325,3841,3132,1513,1619,63,63,285,206,79,356,299,57,5
2021,Wigan 040,E02001326,3543,2714,1410,1304,24,24,368,262,106,432,368,64,5
2021,Knowsley 001,E02001327,3630,1490,602,888,28,28,1469,724,745,626,581,45,17
2021,Knowsley 002,E02001328,4412,3359,1459,1900,79,79,374,135,239,599,536,63,1
2021,Knowsley 003,E02001329,3341,1398,695,703,9,9,1317,553,764,610,565,45,7
2021,Knowsley 004,E02001330,3972,2068,1020,1048,12,12,1027,448,579,860,788,72,5
2021,Knowsley 005,E02001331,4337,2313,1225,1088,11,11,1317,564,753,684,578,106,12
2021,Knowsley 006,E02001332,3353,1332,568,764,41,41,1602,274,1328,376,329,47,2
2021,Knowsley 007,E02001333,4409,2182,897,1285,26,26,1241,578,663,950,868,82,10
2021,Knowsley 008,E02001334,2824,1119,462,657,12,12,1432,705,727,254,223,31,7
2021,Knowsley 009,E02001335,3457,2526,1173,1353,20,20,334,146,188,576,506,70,1
2021,Knowsley 010,E02001336,3039,1066,511,555,40,40,1518,783,735,409,380,29,6
2021,Knowsley 011,E02001337,2407,1581,806,775,16,16,500,207,293,304,256,48,6
2021,Knowsley 012,E02001338,2646,1613,743,870,41,41,514,210,304,473,425,48,5
2021,Knowsley 013,E02001339,2688,1541,761,780,18,18,794,395,399,331,287,44,4
2021,Knowsley 014,E02001340,4012,3445,1662,1783,8,8,137,54,83,419,360,59,3
2021,Knowsley 015,E02001341,3353,1685,841,844,24,24,1100,525,575,538,451,87,6
2021,Knowsley 016,E02001342,3197,2862,1487,1375,29,29,71,18,53,235,196,39,0
2021,Knowsley 017,E02001343,3021,2607,1390,1217,15,15,65,24,41,333,263,70,1
2021,Knowsley 018,E02001344,2382,1446,738,708,41,41,635,228,407,260,236,24,0
2021,Knowsley 019,E02001345,2337,1950,1055,895,52,52,113,30,83,222,184,38,0
2021,Knowsley 020,E02001346,3256,1706,810,896,17,17,1126,506,620,404,355,49,3
2021,Liverpool 001,E02001347,3413,1876,896,980,31,31,943,205,738,559,459,100,4
2021,Liverpool 002,E02001348,2995,2021,1028,993,5,5,177,24,153,792,718,74,0
2021,Liverpool 003,E02001349,3249,2246,1140,1106,4,4,197,34,163,801,734,67,1
2021,Liverpool 004,E02001350,3391,1477,647,830,26,26,1335,278,1057,547,495,52,6
2021,Liverpool 005,E02001351,3519,1431,730,701,9,9,1499,358,1141,577,527,50,3
2021,Liverpool 006,E02001352,2939,1121,573,548,70,70,951,154,797,790,747,43,7
2021,Liverpool 007,E02001353,2952,2322,1121,1201,34,34,215,42,173,380,332,48,1
2021,Liverpool 008,E02001354,3429,1635,847,788,6,6,1217,292,925,569,502,67,2
2021,Liverpool 009,E02001355,2956,1352,787,565,7,7,736,85,651,858,793,65,3
2021,Liverpool 010,E02001356,3583,1376,443,933,8,8,1670,359,1311,524,485,39,5
2021,Liverpool 011,E02001357,2819,1212,650,562,5,5,1305,332,973,293,241,52,4
2021,Liverpool 012,E02001358,3270,1238,730,508,7,7,666,86,580,1354,1261,93,5
2021,Liverpool 013,E02001359,2325,1685,950,735,4,4,353,63,290,283,236,47,0
2021,Liverpool 014,E02001360,4125,1199,758,441,10,10,1849,412,1437,1059,988,71,8
2021,Liverpool 015,E02001361,3311,1637,951,686,19,19,1027,161,866,623,553,70,5
2021,Liverpool 016,E02001362,3181,2049,1147,902,12,12,759,169,590,358,289,69,3
2021,Liverpool 017,E02001363,3474,1453,705,748,10,10,1292,319,973,713,656,57,6
2021,Liverpool 018,E02001364,2704,882,443,439,12,12,1072,110,962,735,685,50,3
2021,Liverpool 019,E02001365,4085,1518,881,637,19,19,571,66,505,1965,1864,101,12
2021,Liverpool 020,E02001366,3954,1938,1065,873,15,15,650,114,536,1336,1229,107,15
2021,Liverpool 021,E02001367,4093,3127,1651,1476,10,10,341,56,285,614,540,74,1
2021,Liverpool 022,E02001368,3440,864,391,473,45,45,1822,343,1479,704,672,32,5
2021,Liverpool 023,E02001369,3736,983,566,417,25,25,1899,354,1545,823,758,65,6
2021,Liverpool 024,E02001370,3335,698,390,308,34,34,1840,282,1558,757,702,55,6
2021,Liverpool 025,E02001371,3178,1431,598,833,10,10,1170,292,878,565,512,53,2
2021,Liverpool 026,E02001372,2701,1561,820,741,16,16,730,115,615,392,351,41,2
2021,Liverpool 027,E02001373,3951,2074,1111,963,12,12,685,104,581,1173,1089,84,7
2021,Liverpool 028,E02001374,3961,1108,561,547,17,17,1083,127,956,1745,1628,117,8
2021,Liverpool 029,E02001375,3080,1682,896,786,10,10,596,114,482,789,703,86,3
2021,Liverpool 030,E02001376,3715,876,589,287,20,20,979,191,788,1829,1702,127,11
2021,Liverpool 031,E02001377,3802,865,462,403,17,17,1360,185,1175,1554,1472,82,6
2021,Liverpool 032,E02001378,3401,1784,905,879,31,31,883,131,752,700,630,70,3
2021,Liverpool 034,E02001380,3104,2585,1325,1260,18,18,138,29,109,362,318,44,1
2021,Liverpool 035,E02001381,4274,1533,840,693,19,19,967,157,810,1748,1635,113,7
2021,Liverpool 036,E02001382,2724,2422,1251,1171,2,2,78,24,54,219,178,41,3
2021,Liverpool 037,E02001383,4193,412,169,243,38,38,2095,212,1883,1638,1556,82,10
2021,Liverpool 038,E02001384,3655,1135,575,560,25,25,599,61,538,1895,1828,67,1
2021,Liverpool 039,E02001385,3434,529,288,241,52,52,1851,274,1577,980,891,89,22
2021,Liverpool 040,E02001386,3797,1605,819,786,150,150,1725,236,1489,313,246,67,4
2021,Liverpool 041,E02001387,3113,2674,1496,1178,5,5,45,17,28,388,334,54,1
2021,Liverpool 042,E02001388,2906,1796,750,1046,10,10,185,26,159,914,860,54,1
2021,Liverpool 043,E02001389,3602,661,305,356,23,23,1261,115,1146,1654,1587,67,3
2021,Liverpool 044,E02001390,4367,955,474,481,52,52,2333,381,1952,1019,921,98,8
2021,Liverpool 045,E02001391,2521,1220,651,569,48,48,953,169,784,297,263,34,3
2021,Liverpool 046,E02001392,2794,2367,1350,1017,20,20,127,22,105,279,228,51,1
2021,Liverpool 047,E02001393,2849,2540,1543,997,2,2,60,12,48,247,193,54,0
2021,Liverpool 048,E02001394,4260,1907,987,920,7,7,966,48,918,1379,1277,102,1
2021,Liverpool 049,E02001395,2514,2044,1098,946,12,12,93,11,82,364,320,44,1
2021,Liverpool 050,E02001396,3821,1733,852,881,34,34,870,130,740,1183,1102,81,1
2021,Liverpool 051,E02001397,3615,2208,1264,944,14,14,827,106,721,565,512,53,1
2021,Liverpool 052,E02001398,3530,1916,999,917,27,27,694,42,652,893,831,62,0
2021,Liverpool 053,E02001399,2834,2410,1319,1091,4,4,209,14,195,211,172,39,0
2021,Liverpool 054,E02001400,2892,1945,990,955,19,19,642,123,519,283,247,36,3
2021,Liverpool 055,E02001401,3456,2679,1453,1226,15,15,282,44,238,480,430,50,0
2021,Liverpool 056,E02001402,3858,2788,1466,1322,28,28,334,40,294,708,651,57,0
2021,Liverpool 057,E02001403,2919,1378,595,783,37,37,792,119,673,709,652,57,3
2021,Liverpool 058,E02001404,3420,1634,666,968,11,11,1208,236,972,567,502,65,0
2021,Liverpool 059,E02001405,4249,1372,622,750,40,40,2204,466,1738,631,574,57,2
2021,St. Helens 001,E02001406,3504,2928,1877,1051,15,15,232,66,166,329,274,55,0
2021,St. Helens 002,E02001407,2582,2172,1398,774,8,8,237,72,165,165,137,28,0
2021,St. Helens 003,E02001408,2371,1990,1179,811,9,9,165,75,90,204,161,43,3
2021,St. Helens 004,E02001409,4572,2999,1625,1374,22,22,1093,305,788,452,368,84,6
2021,St. Helens 005,E02001410,2532,1604,894,710,3,3,580,216,364,336,287,49,9
2021,St. Helens 006,E02001411,2565,1753,993,760,41,41,396,133,263,373,336,37,2
2021,St. Helens 007,E02001412,3831,2749,1428,1321,10,10,595,174,421,473,392,81,4
2021,St. Helens 008,E02001413,4053,2901,1712,1189,16,16,698,259,439,437,360,77,1
2021,St. Helens 009,E02001414,2369,2130,1324,806,6,6,73,15,58,160,122,38,0
2021,St. Helens 010,E02001415,2913,1738,756,982,38,38,772,245,527,364,324,40,1
2021,St. Helens 011,E02001416,2765,1211,599,612,10,10,989,362,627,550,494,56,5
2021,St. Helens 012,E02001417,3853,1494,733,761,27,27,1219,261,958,1107,1014,93,6
2021,St. Helens 013,E02001418,3115,1672,699,973,67,67,764,228,536,610,561,49,2
2021,St. Helens 014,E02001419,3676,1313,721,592,69,69,1069,324,745,1218,1140,78,7
2021,St. Helens 015,E02001420,5143,3283,1404,1879,48,48,1162,347,815,646,548,98,4
2021,St. Helens 016,E02001421,4885,3108,1639,1469,66,66,621,203,418,1088,956,132,2
2021,St. Helens 017,E02001422,2794,1236,576,660,14,14,1012,420,592,522,482,40,10
2021,St. Helens 018,E02001423,2831,2304,1281,1023,3,3,278,85,193,244,201,43,2
2021,St. Helens 020,E02001425,4768,3205,1816,1389,14,14,821,222,599,726,641,85,2
2021,St. Helens 021,E02001426,2420,1780,1067,713,49,49,267,62,205,320,284,36,4
2021,St. Helens 022,E02001427,4623,2692,1348,1344,36,36,1167,359,808,724,635,89,4
2021,St. Helens 023,E02001428,2366,2083,1289,794,6,6,78,22,56,199,163,36,0
2021,Sefton 001,E02001429,3097,2599,1628,971,11,11,113,29,84,374,306,68,0
2021,Sefton 002,E02001430,2981,2566,1561,1005,5,5,75,14,61,335,291,44,0
2021,Sefton 003,E02001431,3721,2433,1713,720,22,22,552,77,475,710,643,67,4
2021,Sefton 004,E02001432,5184,1733,1154,579,90,90,426,31,395,2935,2775,160,0
2021,Sefton 005,E02001433,3136,2132,1047,1085,21,21,279,48,231,704,626,78,0
2021,Sefton 006,E02001434,2954,2112,997,1115,14,14,193,21,172,635,566,69,0
2021,Sefton 007,E02001435,3808,1964,1040,924,68,68,206,20,186,1570,1451,119,0
2021,Sefton 008,E02001436,4076,2846,1491,1355,96,96,355,26,329,778,669,109,1
2021,Sefton 009,E02001437,4307,3204,2145,1059,22,22,240,13,227,840,757,83,1
2021,Sefton 010,E02001438,3069,2436,1318,1118,3,3,174,57,117,456,403,53,0
2021,Sefton 011,E02001439,2881,1883,1055,828,33,33,561,163,398,404,352,52,0
2021,Sefton 012,E02001440,2634,2434,1679,755,17,17,30,7,23,153,117,36,0
2021,Sefton 013,E02001441,2663,2475,1676,799,6,6,28,3,25,154,118,36,0
2021,Sefton 014,E02001442,2701,2131,1386,745,19,19,179,35,144,371,315,56,1
2021,Sefton 015,E02001443,2329,2065,1299,766,8,8,88,16,72,168,140,28,0
2021,Sefton 016,E02001444,2420,2056,1224,832,6,6,55,19,36,303,254,49,0
2021,Sefton 017,E02001445,2944,2580,1523,1057,11,11,102,35,67,251,208,43,0
2021,Sefton 018,E02001446,3065,2606,1501,1105,10,10,190,36,154,259,211,48,0
2021,Sefton 019,E02001447,2663,2127,1236,891,39,39,199,38,161,298,262,36,0
2021,Sefton 020,E02001448,2836,2475,1388,1087,10,10,95,16,79,256,224,32,0
2021,Sefton 021,E02001449,3973,3132,1772,1360,10,10,481,158,323,346,291,55,4
2021,Sefton 022,E02001450,3662,2972,1789,1183,8,8,144,26,118,538,456,82,0
2021,Sefton 023,E02001451,2611,1390,764,626,21,21,826,302,524,370,326,44,4
2021,Sefton 024,E02001452,2927,1190,602,588,12,12,1360,505,855,365,319,46,0
2021,Sefton 025,E02001453,3627,3012,1597,1415,12,12,247,33,214,355,290,65,1
2021,Sefton 026,E02001454,3004,2508,1309,1199,10,10,182,56,126,303,239,64,1
2021,Sefton 027,E02001455,2996,2493,1301,1192,5,5,189,32,157,309,236,73,0
2021,Sefton 028,E02001456,3244,2313,1244,1069,8,8,267,24,243,656,566,90,0
2021,Sefton 029,E02001457,3000,1386,695,691,63,63,1202,366,836,344,305,39,5
2021,Sefton 030,E02001458,3431,2205,1049,1156,3,3,253,34,219,969,892,77,1
2021,Sefton 031,E02001459,2876,1795,904,891,7,7,645,240,405,427,378,49,2
2021,Sefton 032,E02001460,3825,1638,834,804,41,41,1249,254,995,895,832,63,2
2021,Sefton 033,E02001461,2974,2234,1089,1145,22,22,411,133,278,306,262,44,1
2021,Sefton 034,E02001462,3554,1141,565,576,34,34,1482,222,1260,896,839,57,1
2021,Sefton 035,E02001463,3053,1617,702,915,6,6,1082,375,707,345,306,39,3
2021,Sefton 036,E02001464,3232,1212,650,562,32,32,911,144,767,1077,984,93,0
2021,Sefton 037,E02001465,3837,1035,529,506,35,35,1731,358,1373,1025,945,80,11
2021,Sefton 038,E02001466,3784,1864,974,890,12,12,934,194,740,973,875,98,1
2021,Wirral 001,E02001467,3887,2245,1247,998,26,26,437,36,401,1179,1068,111,0
2021,Wirral 002,E02001468,3358,2074,1008,1066,18,18,261,45,216,1004,928,76,1
2021,Wirral 003,E02001469,3498,2602,1514,1088,18,18,261,49,212,614,549,65,3
2021,Wirral 004,E02001470,3403,2810,1545,1265,3,3,70,20,50,520,461,59,0
2021,Wirral 005,E02001471,3291,1573,777,796,23,23,483,64,419,1211,1134,77,1
2021,Wirral 006,E02001472,2926,2016,1072,944,11,11,492,104,388,407,356,51,0
2021,Wirral 007,E02001473,3393,2265,1183,1082,11,11,218,42,176,899,830,69,0
2021,Wirral 008,E02001474,3103,1052,534,518,15,15,988,195,793,1048,1003,45,0
2021,Wirral 009,E02001475,2811,1232,608,624,1,1,1161,384,777,410,372,38,7
2021,Wirral 010,E02001476,3635,1547,725,822,40,40,935,253,682,1105,1039,66,8
2021,Wirral 011,E02001477,3328,971,430,541,4,4,1816,716,1100,530,494,36,7
2021,Wirral 012,E02001478,3635,2540,1441,1099,30,30,581,209,372,480,401,79,4
2021,Wirral 013,E02001479,2597,2238,1226,1012,6,6,90,29,61,263,221,42,0
2021,Wirral 014,E02001480,3356,2540,1482,1058,3,3,202,34,168,611,555,56,0
2021,Wirral 015,E02001481,3517,2505,1309,1196,9,9,260,77,183,743,675,68,0
2021,Wirral 016,E02001482,4372,894,499,395,43,43,2235,384,1851,1197,1132,65,3
2021,Wirral 017,E02001483,3208,2737,1548,1189,15,15,102,31,71,353,300,53,1
2021,Wirral 018,E02001484,3612,2698,1456,1242,26,26,410,119,291,474,403,71,4
2021,Wirral 019,E02001485,2830,1409,704,705,22,22,1012,377,635,383,335,48,4
2021,Wirral 020,E02001486,4284,2354,1423,931,38,38,615,48,567,1273,1165,108,4
2021,Wirral 021,E02001487,4394,1645,760,885,73,73,975,137,838,1698,1565,133,3
2021,Wirral 022,E02001488,3934,2214,1124,1090,20,20,410,95,315,1277,1197,80,13
2021,Wirral 023,E02001489,3635,3171,1999,1172,21,21,150,29,121,293,233,60,0
2021,Wirral 024,E02001490,3437,2929,1577,1352,11,11,94,26,68,401,349,52,2
2021,Wirral 025,E02001491,3032,1368,727,641,20,20,1078,443,635,560,494,66,6
2021,Wirral 026,E02001492,3525,2474,1499,975,23,23,320,71,249,708,623,85,0
2021,Wirral 027,E02001493,4168,1200,540,660,52,52,1469,366,1103,1442,1362,80,5
2021,Wirral 028,E02001494,2994,2690,1653,1037,7,7,80,11,69,216,187,29,1
2021,Wirral 029,E02001495,3458,2228,1123,1105,69,69,467,136,331,688,626,62,6
2021,Wirral 030,E02001496,2530,1992,1079,913,9,9,278,82,196,251,223,28,0
2021,Wirral 031,E02001497,3683,1695,892,803,24,24,1138,273,865,824,703,121,2
2021,Wirral 032,E02001498,3044,2366,1274,1092,20,20,251,66,185,405,337,68,2
2021,Wirral 033,E02001499,2885,2511,1540,971,13,13,98,25,73,263,205,58,0
2021,Wirral 034,E02001500,3251,2756,1572,1184,6,6,202,47,155,287,233,54,0
2021,Wirral 035,E02001501,3242,2653,1453,1200,8,8,247,69,178,334,283,51,0
2021,Wirral 036,E02001502,4277,2873,1268,1605,64,64,648,90,558,688,609,79,4
2021,Wirral 037,E02001503,3518,2529,1491,1038,28,28,480,95,385,481,421,60,0
2021,Wirral 038,E02001504,3026,2656,1725,931,13,13,28,7,21,329,285,44,0
2021,Wirral 039,E02001505,2870,1993,1044,949,13,13,471,154,317,392,330,62,1
2021,Wirral 040,E02001506,3812,3582,2300,1282,2,2,37,13,24,190,156,34,1
2021,Wirral 041,E02001507,2993,2701,1635,1066,7,7,87,9,78,198,165,33,0
2021,Wirral 042,E02001508,3497,2578,1322,1256,21,21,434,157,277,462,391,71,2
2021,Barnsley 001,E02001509,3013,2024,994,1030,44,44,586,480,106,348,294,54,11
2021,Barnsley 002,E02001510,2608,1693,923,770,18,18,475,374,101,417,357,60,5
2021,Barnsley 003,E02001511,2714,1844,1028,816,0,0,428,367,61,427,373,54,15
2021,Barnsley 004,E02001512,3782,2731,1392,1339,5,5,584,486,98,456,384,72,6
2021,Barnsley 005,E02001513,3393,2628,1475,1153,5,5,320,287,33,435,378,57,5
2021,Barnsley 006,E02001514,3195,1823,832,991,14,14,738,516,222,609,535,74,11
2021,Barnsley 007,E02001515,4082,1824,933,891,26,26,1833,1549,284,377,320,57,22
2021,Barnsley 008,E02001516,2631,1670,800,870,3,3,460,421,39,493,426,67,5
2021,Barnsley 009,E02001517,3574,2566,1467,1099,5,5,609,460,149,384,308,76,10
2021,Barnsley 010,E02001518,4621,2943,1536,1407,13,13,884,703,181,769,652,117,12
2021,Barnsley 011,E02001519,3218,1889,897,992,6,6,873,675,198,440,366,74,10
2021,Barnsley 012,E02001520,5237,4010,2280,1730,44,44,538,399,139,630,535,95,15
2021,Barnsley 013,E02001521,5809,2652,1318,1334,37,37,681,477,204,2421,2264,157,18
2021,Barnsley 014,E02001522,4187,2149,1195,954,26,26,1205,700,505,798,725,73,9
2021,Barnsley 015,E02001523,3120,2068,1159,909,14,14,197,144,53,840,772,68,1
2021,Barnsley 016,E02001524,2690,2192,1343,849,19,19,194,152,42,284,231,53,1
2021,Barnsley 017,E02001525,3222,1239,621,618,27,27,1029,653,376,897,839,58,30
2021,Barnsley 018,E02001526,2633,1172,580,592,16,16,1069,887,182,363,326,37,13
2021,Barnsley 019,E02001527,2670,1892,1029,863,3,3,455,413,42,310,267,43,10
2021,Barnsley 020,E02001528,4673,2858,1674,1184,31,31,993,753,240,781,674,107,10
2021,Barnsley 021,E02001529,4269,2442,1418,1024,14,14,1306,1183,123,494,402,92,13
2021,Barnsley 022,E02001530,3182,1772,825,947,6,6,562,420,142,835,756,79,7
2021,Barnsley 023,E02001531,3552,1926,958,968,2,2,812,525,287,806,728,78,6
2021,Barnsley 024,E02001532,4550,3381,1748,1633,34,34,574,408,166,557,471,86,4
2021,Barnsley 025,E02001533,3278,2134,1032,1102,6,6,496,444,52,633,560,73,9
2021,Barnsley 026,E02001534,4156,2564,1189,1375,30,30,808,698,110,738,637,101,16
2021,Barnsley 027,E02001535,2769,2109,1206,903,6,6,310,246,64,339,261,78,5
2021,Barnsley 028,E02001536,3973,2701,1439,1262,38,38,645,555,90,575,492,83,14
2021,Barnsley 029,E02001537,3770,2346,1152,1194,22,22,716,563,153,679,602,77,7
2021,Barnsley 030,E02001538,3483,2109,1175,934,16,16,919,839,80,425,358,67,14
2021,Doncaster 001,E02001539,2686,1561,869,692,8,8,624,470,154,481,427,54,12
2021,Doncaster 002,E02001540,5124,3352,1820,1532,31,31,794,653,141,934,816,118,13
2021,Doncaster 003,E02001541,5071,3139,1768,1371,53,53,908,722,186,956,840,116,15
2021,Doncaster 004,E02001542,3140,1654,913,741,7,7,922,808,114,540,482,58,17
2021,Doncaster 005,E02001543,3460,2084,1176,908,5,5,773,682,91,578,491,87,20
2021,Doncaster 006,E02001544,3563,2377,1221,1156,6,6,643,603,40,530,451,79,7
2021,Doncaster 007,E02001545,3879,3143,1868,1275,33,33,248,191,57,449,388,61,6
2021,Doncaster 008,E02001546,2969,2412,1450,962,15,15,153,117,36,387,308,79,2
2021,Doncaster 009,E02001547,4478,2695,1257,1438,21,21,1079,864,215,668,570,98,15
2021,Doncaster 010,E02001548,3561,1620,771,849,43,43,980,676,304,903,820,83,15
2021,Doncaster 011,E02001549,2700,2018,1101,917,8,8,288,221,67,381,335,46,5
2021,Doncaster 012,E02001550,3367,2359,1098,1261,27,27,551,495,56,419,347,72,11
2021,Doncaster 013,E02001551,2755,1691,916,775,11,11,220,188,32,830,747,83,3
2021,Doncaster 014,E02001552,3210,1864,797,1067,6,6,506,404,102,819,751,68,15
2021,Doncaster 015,E02001553,4322,2607,1303,1304,5,5,998,860,138,695,597,98,17
2021,Doncaster 016,E02001554,2653,2131,1168,963,20,20,171,149,22,329,292,37,2
2021,Doncaster 017,E02001555,2461,1976,1225,751,7,7,167,142,25,309,254,55,2
2021,Doncaster 018,E02001556,3761,2037,973,1064,6,6,1080,993,87,617,514,103,21
2021,Doncaster 019,E02001557,4667,2369,1259,1110,16,16,273,73,200,2001,1870,131,8
2021,Doncaster 020,E02001558,2767,2062,1318,744,19,19,347,266,81,334,282,52,5
2021,Doncaster 021,E02001559,3236,2692,1556,1136,5,5,59,47,12,480,391,89,0
2021,Doncaster 022,E02001560,4974,1567,867,700,13,13,870,551,319,2513,2358,155,11
2021,Doncaster 023,E02001561,2926,1048,551,497,16,16,1001,788,213,845,763,82,16
2021,Doncaster 024,E02001562,2608,1492,765,727,5,5,729,637,92,365,321,44,17
2021,Doncaster 025,E02001563,3473,2674,1554,1120,8,8,304,234,70,483,417,66,4
2021,Doncaster 026,E02001564,3540,3053,1768,1285,8,8,118,90,28,360,268,92,1
2021,Doncaster 027,E02001565,3358,2714,1468,1246,30,30,123,89,34,488,425,63,3
2021,Doncaster 028,E02001566,3669,1858,745,1113,25,25,602,429,173,1165,1094,71,19
2021,Doncaster 029,E02001567,3728,2166,1204,962,9,9,924,748,176,613,522,91,16
2021,Doncaster 030,E02001568,3082,1641,788,853,6,6,882,796,86,544,482,62,9
2021,Doncaster 031,E02001569,3953,1999,1061,938,15,15,990,757,233,940,855,85,9
2021,Doncaster 032,E02001570,3242,1430,700,730,5,5,1281,1108,173,497,424,73,29
2021,Doncaster 033,E02001571,2617,1959,1126,833,6,6,207,190,17,438,385,53,7
2021,Doncaster 034,E02001572,3395,1921,883,1038,17,17,773,580,193,673,615,58,11
2021,Doncaster 035,E02001573,3185,2083,1120,963,4,4,596,542,54,488,405,83,14
2021,Doncaster 036,E02001574,2640,2128,1174,954,14,14,106,95,11,392,326,66,0
2021,Doncaster 037,E02001575,3269,1750,718,1032,5,5,851,796,55,648,577,71,15
2021,Doncaster 038,E02001576,3015,2218,1011,1207,16,16,292,132,160,485,439,46,4
2021,Doncaster 039,E02001577,2982,2341,1550,791,9,9,261,212,49,367,302,65,4
2021,Rotherham 001,E02001578,4754,3108,1251,1857,23,23,960,804,156,649,550,99,14
2021,Rotherham 002,E02001579,4275,2496,1361,1135,32,32,1130,841,289,603,526,77,14
2021,Rotherham 003,E02001580,3883,2609,1476,1133,16,16,759,588,171,490,432,58,9
2021,Rotherham 004,E02001581,2716,1842,962,880,4,4,630,601,29,233,186,47,7
2021,Rotherham 005,E02001582,3308,2110,1081,1029,16,16,867,808,59,302,256,46,13
2021,Rotherham 006,E02001583,2388,1503,767,736,17,17,392,328,64,467,407,60,9
2021,Rotherham 007,E02001584,2982,2274,1331,943,1,1,276,177,99,428,355,73,3
2021,Rotherham 008,E02001585,2916,1274,599,675,26,26,1076,872,204,520,474,46,20
2021,Rotherham 009,E02001586,3955,1840,1034,806,7,7,1638,1482,156,449,393,56,21
2021,Rotherham 010,E02001587,2621,1282,633,649,5,5,1009,863,146,310,268,42,15
2021,Rotherham 011,E02001588,3049,1541,744,797,5,5,1171,1139,32,312,268,44,20
2021,Rotherham 012,E02001589,3450,2747,1421,1326,17,17,247,217,30,436,358,78,3
2021,Rotherham 013,E02001590,2982,1103,511,592,12,12,1482,1370,112,363,336,27,22
2021,Rotherham 014,E02001591,3263,1478,829,649,16,16,1025,700,325,728,637,91,16
2021,Rotherham 015,E02001592,3785,2674,1517,1157,25,25,636,569,67,441,365,76,9
2021,Rotherham 016,E02001593,2949,1088,592,496,35,35,920,495,425,890,798,92,16
2021,Rotherham 017,E02001594,3070,857,497,360,12,12,996,661,335,1185,1049,136,20
2021,Rotherham 018,E02001595,3590,2834,1512,1322,6,6,310,284,26,434,342,92,6
2021,Rotherham 019,E02001596,3753,2465,1485,980,3,3,589,436,153,685,616,69,11
2021,Rotherham 020,E02001597,4131,2192,1228,964,7,7,980,566,414,941,852,89,11
2021,Rotherham 021,E02001598,4033,2744,1471,1273,18,18,796,634,162,462,379,83,13
2021,Rotherham 023,E02001600,4142,3017,1781,1236,2,2,415,277,138,685,566,119,23
2021,Rotherham 025,E02001602,3937,2796,1566,1230,18,18,573,457,116,545,461,84,5
2021,Rotherham 026,E02001603,3202,2028,1022,1006,15,15,630,524,106,514,442,72,15
2021,Rotherham 027,E02001604,4772,3464,1219,2245,52,52,641,537,104,601,527,74,14
2021,Rotherham 028,E02001605,3299,2331,1163,1168,11,11,414,267,147,539,460,79,4
2021,Rotherham 029,E02001606,3430,2329,1321,1008,7,7,482,346,136,607,528,79,5
2021,Rotherham 030,E02001607,3827,2625,1453,1172,4,4,779,691,88,408,342,66,11
2021,Rotherham 031,E02001608,2952,2315,1141,1174,4,4,255,228,27,374,304,70,4
2021,Rotherham 032,E02001609,3720,2987,1825,1162,6,6,371,345,26,346,285,61,10
2021,Rotherham 033,E02001610,3737,2737,1435,1302,14,14,456,347,109,523,427,96,7
2021,Sheffield 001,E02001611,3436,2450,1350,1100,9,9,532,438,94,442,373,69,3
2021,Sheffield 002,E02001612,2531,2008,1118,890,3,3,246,237,9,274,233,41,0
2021,Sheffield 003,E02001613,4531,3208,1764,1444,8,8,890,808,82,423,359,64,2
2021,Sheffield 004,E02001614,4781,3826,2105,1721,6,6,419,370,49,530,451,79,0
2021,Sheffield 005,E02001615,3281,2810,1767,1043,9,9,141,112,29,321,264,57,0
2021,Sheffield 006,E02001616,3230,2015,1030,985,2,2,878,794,84,334,283,51,1
2021,Sheffield 007,E02001617,2332,930,415,515,0,0,1092,204,888,309,277,32,1
2021,Sheffield 008,E02001618,4097,3175,1646,1529,21,21,448,323,125,453,354,99,0
2021,Sheffield 009,E02001619,4226,2083,953,1130,6,6,1738,1668,70,397,313,84,2
2021,Sheffield 010,E02001620,2838,1187,574,613,18,18,1217,304,913,414,364,50,2
2021,Sheffield 011,E02001621,2513,1137,532,605,15,15,1066,865,201,295,247,48,0
2021,Sheffield 012,E02001622,4005,1862,969,893,5,5,1652,1439,213,484,433,51,2
2021,Sheffield 013,E02001623,3228,1050,583,467,7,7,1721,1434,287,439,387,52,11
2021,Sheffield 014,E02001624,4088,2546,1331,1215,20,20,706,353,353,809,722,87,7
2021,Sheffield 015,E02001625,3205,1350,712,638,3,3,1484,1213,271,365,297,68,3
2021,Sheffield 016,E02001626,2542,1797,975,822,0,0,392,30,362,353,318,35,0
2021,Sheffield 017,E02001627,2871,1597,803,794,5,5,351,281,70,917,844,73,1
2021,Sheffield 018,E02001628,2140,1011,611,400,6,6,614,460,154,506,430,76,3
2021,Sheffield 019,E02001629,2823,1110,598,512,17,17,1235,1082,153,441,379,62,20
2021,Sheffield 020,E02001630,2861,1479,919,560,8,8,572,353,219,798,689,109,4
2021,Sheffield 021,E02001631,3405,2346,1148,1198,6,6,505,106,399,545,448,97,3
2021,Sheffield 022,E02001632,4356,1255,798,457,48,48,1594,1137,457,1445,1337,108,14
2021,Sheffield 023,E02001633,3303,2725,1596,1129,7,7,362,278,84,206,157,49,3
2021,Sheffield 024,E02001634,4419,2919,1374,1545,11,11,425,255,170,1064,964,100,0
2021,Sheffield 025,E02001635,2867,1827,1042,785,4,4,834,793,41,202,164,38,0
2021,Sheffield 026,E02001636,4081,1194,650,544,9,9,1742,1476,266,1116,1027,89,20
2021,Sheffield 027,E02001637,2680,989,486,503,10,10,1061,575,486,612,544,68,8
2021,Sheffield 028,E02001638,2148,997,458,539,7,7,101,68,33,1042,992,50,1
2021,Sheffield 029,E02001639,2719,1695,867,828,10,10,207,164,43,807,736,71,0
2021,Sheffield 030,E02001640,3014,1052,574,478,21,21,433,157,276,1506,1456,50,2
2021,Sheffield 032,E02001642,4244,2990,1469,1521,7,7,467,412,55,780,693,87,0
2021,Sheffield 033,E02001643,2677,2140,1286,854,2,2,287,194,93,247,225,22,1
2021,Sheffield 036,E02001646,2498,1111,630,481,8,8,212,85,127,1163,1095,68,4
2021,Sheffield 037,E02001647,2717,1837,999,838,15,15,580,231,349,282,237,45,3
2021,Sheffield 038,E02001648,2571,1912,1109,803,5,5,118,25,93,536,473,63,0
2021,Sheffield 039,E02001649,4692,1508,547,961,31,31,2394,746,1648,756,686,70,3
2021,Sheffield 040,E02001650,3512,724,371,353,8,8,1064,800,264,1705,1631,74,11
2021,Sheffield 041,E02001651,3288,2963,1780,1183,1,1,68,57,11,255,211,44,1
2021,Sheffield 042,E02001652,3717,1199,559,640,17,17,511,297,214,1984,1880,104,6
2021,Sheffield 043,E02001653,3266,1222,487,735,35,35,1330,892,438,677,614,63,2
2021,Sheffield 044,E02001654,2642,1841,980,861,35,35,540,295,245,224,190,34,2
2021,Sheffield 045,E02001655,3349,1821,877,944,4,4,1205,830,375,319,280,39,0
2021,Sheffield 046,E02001656,3086,2142,1091,1051,7,7,60,11,49,875,805,70,2
2021,Sheffield 047,E02001657,3645,3050,1501,1549,10,10,71,14,57,514,467,47,0
2021,Sheffield 048,E02001658,2241,676,325,351,2,2,1331,1122,209,227,204,23,5
2021,Sheffield 049,E02001659,2880,1359,730,629,7,7,1165,1039,126,344,304,40,5
2021,Sheffield 050,E02001660,4111,2579,1318,1261,32,32,272,60,212,1223,1100,123,5
2021,Sheffield 051,E02001661,3532,1553,768,785,10,10,1476,1271,205,489,425,64,4
2021,Sheffield 052,E02001662,3367,2238,1195,1043,5,5,647,369,278,476,406,70,1
2021,Sheffield 053,E02001663,3281,2306,1030,1276,8,8,114,27,87,853,771,82,0
2021,Sheffield 054,E02001664,2808,2016,1154,862,3,3,480,431,49,306,269,37,3
2021,Sheffield 055,E02001665,3995,3608,2136,1472,3,3,108,44,64,276,217,59,0
2021,Sheffield 056,E02001666,2541,1532,713,819,9,9,674,547,127,323,270,53,3
2021,Sheffield 059,E02001669,3545,2487,1162,1325,7,7,209,162,47,841,756,85,1
2021,Sheffield 060,E02001670,2693,1073,569,504,2,2,1293,1083,210,322,275,47,3
2021,Sheffield 061,E02001671,2624,2010,1250,760,12,12,360,249,111,242,190,52,0
2021,Sheffield 062,E02001672,2694,1936,1040,896,3,3,470,422,48,285,242,43,0
2021,Sheffield 063,E02001673,2156,1857,971,886,10,10,49,21,28,239,205,34,1
2021,Sheffield 064,E02001674,4049,3258,1884,1374,3,3,455,270,185,332,254,78,1
2021,Sheffield 065,E02001675,4009,2407,1422,985,4,4,1217,1051,166,380,299,81,1
2021,Sheffield 066,E02001676,2528,2223,1269,954,6,6,162,134,28,137,114,23,0
2021,Sheffield 068,E02001678,4474,3831,2305,1526,8,8,261,216,45,374,315,59,0
2021,Sheffield 069,E02001679,2936,1438,771,667,4,4,1136,1083,53,352,304,48,6
2021,Sheffield 070,E02001680,3050,966,517,449,11,11,1726,1601,125,339,288,51,8
2021,Sheffield 071,E02001681,3354,2710,1532,1178,3,3,367,256,111,273,237,36,1
2021,Gateshead 001,E02001682,3792,2667,1372,1295,10,10,740,515,225,374,315,59,1
2021,Gateshead 002,E02001683,4270,3246,1743,1503,25,25,411,349,62,587,507,80,1
2021,Gateshead 003,E02001684,3149,1292,654,638,11,11,1165,855,310,677,609,68,4
2021,Gateshead 004,E02001685,3664,1764,717,1047,25,25,1318,1100,218,555,460,95,2
2021,Gateshead 005,E02001686,3151,2292,1288,1004,4,4,411,340,71,443,396,47,1
2021,Gateshead 007,E02001688,3807,1548,593,955,27,27,1340,991,349,884,802,82,8
2021,Gateshead 008,E02001689,3113,1124,612,512,11,11,897,497,400,1073,989,84,8
2021,Gateshead 009,E02001690,3216,2053,1104,949,8,8,598,455,143,554,504,50,3
2021,Gateshead 010,E02001691,3808,1688,760,928,26,26,586,319,267,1493,1386,107,15
2021,Gateshead 011,E02001692,2708,958,497,461,12,12,1374,755,619,357,330,27,7
2021,Gateshead 012,E02001693,2553,1089,577,512,3,3,1150,889,261,304,260,44,7
2021,Gateshead 013,E02001694,2789,1951,1036,915,6,6,438,346,92,393,333,60,1
2021,Gateshead 014,E02001695,2644,1965,1092,873,4,4,437,341,96,237,190,47,1
2021,Gateshead 015,E02001696,3957,1998,980,1018,4,4,1580,1275,305,371,307,64,4
2021,Gateshead 016,E02001697,3330,2452,1259,1193,29,29,406,329,77,443,396,47,0
2021,Gateshead 017,E02001698,3193,2767,1835,932,4,4,166,126,40,254,211,43,2
2021,Gateshead 018,E02001699,3036,1714,971,743,13,13,952,779,173,354,304,50,3
2021,Gateshead 019,E02001700,4547,3348,1768,1580,12,12,713,604,109,471,394,77,3
2021,Gateshead 020,E02001701,2728,2281,1291,990,12,12,130,49,81,305,257,48,0
2021,Gateshead 021,E02001702,3475,1373,735,638,4,4,1786,1518,268,299,245,54,13
2021,Gateshead 022,E02001703,2495,1878,1136,742,15,15,439,391,48,162,125,37,1
2021,Gateshead 023,E02001704,3297,1660,899,761,4,4,1255,1161,94,367,318,49,11
2021,Gateshead 025,E02001706,3372,1962,881,1081,22,22,1096,951,145,290,237,53,2
2021,Gateshead 026,E02001707,3689,2240,1165,1075,40,40,852,675,177,556,495,61,1
2021,Newcastle upon Tyne 002,E02001709,4405,3251,1807,1444,5,5,186,142,44,963,903,60,0
2021,Newcastle upon Tyne 003,E02001710,4556,2073,1098,975,27,27,1738,1441,297,710,617,93,8
2021,Newcastle upon Tyne 004,E02001711,4318,2226,1133,1093,30,30,1516,1304,212,539,463,76,7
2021,Newcastle upon Tyne 005,E02001712,4150,2862,1569,1293,22,22,431,321,110,831,743,88,4
2021,Newcastle upon Tyne 006,E02001713,4380,3230,1777,1453,18,18,423,290,133,708,634,74,1
2021,Newcastle upon Tyne 007,E02001714,3968,3160,1649,1511,17,17,176,136,40,615,531,84,0
2021,Newcastle upon Tyne 008,E02001715,4903,2240,1086,1154,41,41,1908,1547,361,698,610,88,16
2021,Newcastle upon Tyne 011,E02001718,2959,1434,616,818,109,109,1016,821,195,397,322,75,3
2021,Newcastle upon Tyne 012,E02001719,3767,2660,1432,1228,10,10,413,365,48,675,577,98,9
2021,Newcastle upon Tyne 013,E02001720,3326,1256,761,495,10,10,182,58,124,1875,1811,64,3
2021,Newcastle upon Tyne 014,E02001721,4946,2898,1522,1376,13,13,1402,1110,292,623,529,94,10
2021,Newcastle upon Tyne 015,E02001722,4145,2392,1266,1126,10,10,1223,1062,161,508,430,78,12
2021,Newcastle upon Tyne 016,E02001723,2832,1446,616,830,5,5,700,612,88,675,617,58,6
2021,Newcastle upon Tyne 017,E02001724,3559,1226,661,565,57,57,354,55,299,1922,1858,64,0
2021,Newcastle upon Tyne 018,E02001725,4376,1253,501,752,17,17,1172,650,522,1924,1820,104,10
2021,Newcastle upon Tyne 019,E02001726,4768,2706,1280,1426,19,19,1206,1031,175,830,728,102,7
2021,Newcastle upon Tyne 020,E02001727,4026,2388,1304,1084,32,32,1104,926,178,488,403,85,14
2021,Newcastle upon Tyne 021,E02001728,4292,2680,1381,1299,3,3,884,720,164,714,628,86,11
2021,Newcastle upon Tyne 022,E02001729,4083,1196,610,586,10,10,1201,605,596,1664,1506,158,12
2021,Newcastle upon Tyne 025,E02001732,2455,1196,540,656,14,14,830,630,200,405,334,71,10
2021,Newcastle upon Tyne 027,E02001734,3410,1393,731,662,14,14,1300,771,529,687,598,89,16
2021,Newcastle upon Tyne 028,E02001735,2880,696,314,382,5,5,1856,1679,177,310,266,44,13
2021,Newcastle upon Tyne 030,E02001737,2875,722,328,394,10,10,1883,1450,433,250,207,43,10
2021,North Tyneside 001,E02001738,2616,2419,1540,879,2,2,49,36,13,146,111,35,0
2021,North Tyneside 002,E02001739,3443,2059,1083,976,28,28,1009,723,286,342,299,43,5
2021,North Tyneside 003,E02001740,2303,2018,1059,959,3,3,93,79,14,189,162,27,0
2021,North Tyneside 004,E02001741,3750,2894,1640,1254,21,21,446,319,127,387,300,87,2
2021,North Tyneside 005,E02001742,2605,2171,1260,911,21,21,157,44,113,254,224,30,2
2021,North Tyneside 006,E02001743,3273,2339,1125,1214,20,20,176,86,90,736,671,65,2
2021,North Tyneside 007,E02001744,3681,2630,1058,1572,29,29,598,454,144,423,351,72,1
2021,North Tyneside 008,E02001745,3043,1957,914,1043,53,53,685,562,123,346,280,66,2
2021,North Tyneside 009,E02001746,3627,2526,1280,1246,13,13,529,442,87,559,478,81,0
2021,North Tyneside 010,E02001747,2892,2378,1470,908,6,6,244,219,25,263,207,56,1
2021,North Tyneside 011,E02001748,3720,2355,921,1434,45,45,793,659,134,527,449,78,0
2021,North Tyneside 012,E02001749,2951,1993,1046,947,17,17,576,321,255,360,311,49,5
2021,North Tyneside 013,E02001750,2878,2379,1305,1074,7,7,248,168,80,244,187,57,0
2021,North Tyneside 014,E02001751,3012,2031,940,1091,4,4,624,468,156,351,296,55,2
2021,North Tyneside 015,E02001752,2845,1479,721,758,4,4,979,866,113,380,332,48,3
2021,North Tyneside 016,E02001753,3163,1947,1108,839,10,10,544,189,355,661,598,63,1
2021,North Tyneside 017,E02001754,2788,2086,1140,946,16,16,153,77,76,533,472,61,0
2021,North Tyneside 018,E02001755,4303,3193,1433,1760,9,9,620,427,193,480,422,58,1
2021,North Tyneside 019,E02001756,4378,2070,866,1204,19,19,1676,1259,417,609,550,59,4
2021,North Tyneside 020,E02001757,2755,1932,1127,805,4,4,511,455,56,305,248,57,3
2021,North Tyneside 021,E02001758,2548,1688,911,777,32,32,562,481,81,264,223,41,2
2021,North Tyneside 022,E02001759,3346,1793,904,889,12,12,480,177,303,1056,979,77,5
2021,North Tyneside 023,E02001760,3469,1289,657,632,9,9,1377,1118,259,789,701,88,5
2021,North Tyneside 024,E02001761,2585,1610,888,722,7,7,615,551,64,347,287,60,6
2021,North Tyneside 025,E02001762,3072,2343,1123,1220,35,35,352,213,139,342,276,66,0
2021,North Tyneside 026,E02001763,3000,1357,614,743,4,4,1248,934,314,385,334,51,6
2021,North Tyneside 027,E02001764,3860,1394,634,760,30,30,1565,813,752,870,794,76,1
2021,North Tyneside 028,E02001765,3529,1476,603,873,23,23,1313,905,408,713,646,67,4
2021,North Tyneside 029,E02001766,3442,1663,763,900,17,17,689,475,214,1071,972,99,2
2021,North Tyneside 030,E02001767,3358,1803,905,898,3,3,855,547,308,695,595,100,2
2021,South Tyneside 001,E02001768,3681,2110,1104,1006,71,71,598,433,165,898,767,131,4
2021,South Tyneside 002,E02001769,3959,1326,681,645,18,18,1709,1060,649,901,805,96,5
2021,South Tyneside 003,E02001770,2977,1961,1056,905,38,38,257,47,210,721,641,80,0
2021,South Tyneside 004,E02001771,2773,1550,925,625,33,33,969,840,129,216,189,27,5
2021,South Tyneside 005,E02001772,2410,1477,880,597,15,15,466,321,145,451,386,65,1
2021,South Tyneside 006,E02001773,2363,2036,1294,742,15,15,156,57,99,154,117,37,2
2021,South Tyneside 007,E02001774,2524,1128,589,539,2,2,998,900,98,389,346,43,7
2021,South Tyneside 008,E02001775,2406,1189,603,586,6,6,995,667,328,216,179,37,0
2021,South Tyneside 009,E02001776,4129,2114,936,1178,23,23,1381,844,537,605,528,77,6
2021,South Tyneside 010,E02001777,3045,2076,896,1180,9,9,454,386,68,506,433,73,0
2021,South Tyneside 011,E02001778,2861,1315,653,662,8,8,718,545,173,819,736,83,1
2021,South Tyneside 012,E02001779,2525,1143,610,533,7,7,1046,739,307,327,273,54,2
2021,South Tyneside 013,E02001780,2690,1547,831,716,12,12,947,500,447,184,142,42,0
2021,South Tyneside 014,E02001781,2560,1039,520,519,4,4,1253,1171,82,264,229,35,0
2021,South Tyneside 015,E02001782,4481,2557,1165,1392,11,11,1568,1458,110,331,282,49,14
2021,South Tyneside 016,E02001783,3151,1303,624,679,7,7,1490,1347,143,346,297,49,5
2021,South Tyneside 017,E02001784,2913,1534,822,712,3,3,1183,1057,126,186,158,28,7
2021,South Tyneside 018,E02001785,3527,2243,1252,991,12,12,997,757,240,273,206,67,2
2021,South Tyneside 019,E02001786,3106,1681,890,791,16,16,1101,1047,54,306,266,40,2
2021,South Tyneside 020,E02001787,2418,1431,810,621,9,9,762,646,116,216,181,35,0
2021,South Tyneside 021,E02001788,2662,1582,845,737,4,4,725,531,194,350,306,44,1
2021,South Tyneside 022,E02001789,2499,2318,1412,906,6,6,39,27,12,136,103,33,0
2021,South Tyneside 023,E02001790,2622,1996,1107,889,4,4,396,340,56,225,172,53,1
2021,Sunderland 001,E02001791,2410,2173,1262,911,8,8,36,3,33,193,151,42,0
2021,Sunderland 002,E02001792,3035,2656,1652,1004,11,11,78,17,61,290,232,58,0
2021,Sunderland 003,E02001793,3833,1330,645,685,3,3,1926,817,1109,571,515,56,3
2021,Sunderland 004,E02001794,3873,1641,882,759,17,17,1735,826,909,477,417,60,3
2021,Sunderland 005,E02001795,3527,1587,882,705,36,36,1197,430,767,701,628,73,6
2021,Sunderland 006,E02001796,4236,2539,1521,1018,44,44,711,209,502,941,822,119,1
2021,Sunderland 007,E02001797,2577,2053,1144,909,6,6,280,147,133,238,186,52,0
2021,Sunderland 008,E02001798,3546,1807,958,849,6,6,1306,606,700,422,382,40,5
2021,Sunderland 009,E02001799,4256,1744,918,826,4,4,1795,931,864,712,640,72,1
2021,Sunderland 010,E02001800,2981,1713,909,804,14,14,890,427,463,360,317,43,4
2021,Sunderland 011,E02001801,2362,1234,655,579,10,10,239,50,189,877,789,88,2
2021,Sunderland 012,E02001802,3145,1259,491,768,42,42,1485,615,870,358,304,54,1
2021,Sunderland 013,E02001803,3875,1191,582,609,12,12,1090,386,704,1579,1503,76,3
2021,Sunderland 014,E02001804,2731,1574,776,798,3,3,838,393,445,316,258,58,0
2021,Sunderland 015,E02001805,2447,1830,1113,717,6,6,188,64,124,423,359,64,0
2021,Sunderland 016,E02001806,3817,1203,698,505,8,8,1412,430,982,1192,1085,107,2
2021,Sunderland 017,E02001807,3575,2182,948,1234,14,14,891,414,477,488,420,68,0
2021,Sunderland 018,E02001808,2301,1626,849,777,3,3,69,9,60,599,527,72,4
2021,Sunderland 019,E02001809,2978,1876,1141,735,16,16,729,349,380,357,314,43,0
2021,Sunderland 020,E02001810,3717,2351,1219,1132,28,28,898,447,451,437,368,69,3
2021,Sunderland 021,E02001811,3983,1902,1105,797,6,6,1641,807,834,433,376,57,1
2021,Sunderland 022,E02001812,4267,3715,2297,1418,14,14,73,20,53,464,374,90,1
2021,Sunderland 023,E02001813,4149,1573,781,792,8,8,2153,822,1331,414,351,63,1
2021,Sunderland 024,E02001814,2686,1646,883,763,2,2,698,316,382,340,289,51,0
2021,Sunderland 025,E02001815,4241,3097,1838,1259,10,10,756,340,416,378,327,51,0
2021,Sunderland 026,E02001816,3422,1444,771,673,4,4,1541,647,894,432,368,64,1
2021,Sunderland 027,E02001817,2965,1594,787,807,30,30,944,326,618,396,345,51,1
2021,Sunderland 028,E02001818,4061,2366,1052,1314,6,6,1179,490,689,508,437,71,2
2021,Sunderland 029,E02001819,3117,2526,1567,959,29,29,250,76,174,312,261,51,0
2021,Sunderland 030,E02001820,4110,2738,1270,1468,5,5,1027,436,591,340,265,75,0
2021,Sunderland 031,E02001821,2420,1777,961,816,11,11,435,165,270,197,167,30,0
2021,Sunderland 032,E02001822,3304,2454,1238,1216,2,2,351,136,215,497,441,56,0
2021,Sunderland 033,E02001823,3523,2193,1001,1192,22,22,849,382,467,459,402,57,0
2021,Sunderland 034,E02001824,3900,2408,1451,957,15,15,1031,415,616,444,387,57,2
2021,Sunderland 035,E02001825,3553,2235,1223,1012,20,20,807,336,471,490,426,64,1
2021,Sunderland 036,E02001826,3259,1757,843,914,13,13,1031,482,549,457,392,65,1
2021,Birmingham 001,E02001827,2634,2031,1121,910,3,3,329,137,192,267,231,36,4
2021,Birmingham 002,E02001828,3132,2391,1396,995,5,5,320,243,77,410,358,52,6
2021,Birmingham 003,E02001829,3570,3083,1589,1494,4,4,109,47,62,374,335,39,0
2021,Birmingham 004,E02001830,3988,3287,1926,1361,12,12,151,21,130,526,472,54,12
2021,Birmingham 005,E02001831,4493,2686,1279,1407,31,31,1171,688,483,589,522,67,16
2021,Birmingham 006,E02001832,3432,2687,1499,1188,9,9,291,158,133,437,398,39,8
2021,Birmingham 007,E02001833,2292,1917,996,921,8,8,162,63,99,201,179,22,4
2021,Birmingham 008,E02001834,2406,1476,708,768,4,4,482,410,72,433,383,50,11
2021,Birmingham 009,E02001835,3655,2658,1371,1287,8,8,166,122,44,820,757,63,3
2021,Birmingham 010,E02001836,3705,3029,1690,1339,11,11,233,135,98,425,366,59,7
2021,Birmingham 011,E02001837,4037,1906,831,1075,25,25,1322,1177,145,751,682,69,33
2021,Birmingham 012,E02001838,3172,2770,1546,1224,19,19,53,19,34,325,281,44,5
2021,Birmingham 013,E02001839,2822,1874,924,950,7,7,379,233,146,558,485,73,4
2021,Birmingham 014,E02001840,3807,1677,674,1003,52,52,1461,1019,442,596,535,61,21
2021,Birmingham 015,E02001841,2377,2135,1288,847,1,1,37,9,28,201,173,28,3
2021,Birmingham 016,E02001842,3176,2407,1188,1219,27,27,163,98,65,577,497,80,2
2021,Birmingham 017,E02001843,2840,2117,1168,949,9,9,67,13,54,645,598,47,2
2021,Birmingham 018,E02001844,4433,2823,1494,1329,138,138,601,266,335,868,796,72,3
2021,Birmingham 019,E02001845,2724,1966,898,1068,19,19,138,19,119,599,545,54,2
2021,Birmingham 020,E02001846,3292,1713,780,933,34,34,868,714,154,660,613,47,17
2021,Birmingham 021,E02001847,2354,1879,1030,849,11,11,160,97,63,299,259,40,5
2021,Birmingham 022,E02001848,2597,1266,633,633,14,14,789,623,166,509,446,63,19
2021,Birmingham 023,E02001849,3724,1402,675,727,19,19,1159,920,239,1112,1020,92,32
2021,Birmingham 024,E02001850,3032,2105,1080,1025,10,10,189,98,91,721,623,98,7
2021,Birmingham 025,E02001851,3851,2197,935,1262,29,29,1001,572,429,612,540,72,12
2021,Birmingham 026,E02001852,2852,1536,790,746,40,40,546,205,341,725,646,79,5
2021,Birmingham 029,E02001855,4212,1472,763,709,18,18,2316,273,2043,402,343,59,4
2021,Birmingham 030,E02001856,3611,1845,928,917,22,22,395,111,284,1335,1233,102,14
2021,Birmingham 031,E02001857,5570,2189,1056,1133,60,60,1424,557,867,1879,1772,107,18
2021,Birmingham 032,E02001858,3231,1305,742,563,10,10,759,190,569,1145,1055,90,12
2021,Birmingham 033,E02001859,2933,1498,847,651,14,14,545,174,371,867,757,110,9
2021,Birmingham 034,E02001860,2737,1218,703,515,19,19,628,163,465,862,728,134,10
2021,Birmingham 035,E02001861,3481,1287,779,508,24,24,1342,349,993,814,720,94,14
2021,Birmingham 036,E02001862,3234,1423,803,620,21,21,927,332,595,846,742,104,17
2021,Birmingham 037,E02001863,2444,1000,574,426,12,12,800,373,427,624,540,84,8
2021,Birmingham 039,E02001865,3376,1452,918,534,21,21,945,227,718,937,761,176,21
2021,Birmingham 040,E02001866,2809,986,576,410,20,20,1249,348,901,539,462,77,15
2021,Birmingham 041,E02001867,2589,929,458,471,18,18,1248,748,500,373,309,64,21
2021,Birmingham 042,E02001868,2629,2060,976,1084,6,6,114,73,41,442,381,61,7
2021,Birmingham 043,E02001869,2490,470,277,193,19,19,1722,1209,513,261,236,25,18
2021,Birmingham 044,E02001870,3593,2186,1022,1164,19,19,466,335,131,918,816,102,4
2021,Birmingham 045,E02001871,3559,1626,847,779,115,115,1363,1037,326,443,387,56,12
2021,Birmingham 046,E02001872,3083,1505,683,822,56,56,1096,863,233,402,344,58,24
2021,Birmingham 047,E02001873,3981,1229,705,524,17,17,1460,579,881,1254,1117,137,21
2021,Birmingham 048,E02001874,2683,1254,678,576,14,14,865,468,397,534,465,69,16
2021,Birmingham 049,E02001875,3291,753,342,411,20,20,1620,1085,535,873,804,69,25
2021,Birmingham 050,E02001876,3664,464,225,239,30,30,1852,1367,485,1282,1193,89,36
2021,Birmingham 051,E02001877,3156,1439,846,593,12,12,970,285,685,723,624,99,12
2021,Birmingham 052,E02001878,2709,1068,673,395,20,20,964,514,450,641,569,72,16
2021,Birmingham 053,E02001879,3047,1146,641,505,15,15,1017,530,487,854,757,97,15
2021,Birmingham 054,E02001880,3434,1496,631,865,17,17,1229,992,237,678,596,82,14
2021,Birmingham 055,E02001881,2893,1498,720,778,10,10,779,709,70,592,518,74,14
2021,Birmingham 056,E02001882,3161,1614,835,779,46,46,797,440,357,696,645,51,8
2021,Birmingham 057,E02001883,3627,1580,760,820,18,18,1425,1180,245,586,523,63,18
2021,Birmingham 058,E02001884,2482,1242,629,613,31,31,453,236,217,752,662,90,4
2021,Birmingham 060,E02001886,3470,1738,887,851,34,34,337,93,244,1353,1260,93,8
2021,Birmingham 062,E02001888,2547,1375,622,753,39,39,740,542,198,376,328,48,17
2021,Birmingham 063,E02001889,2243,1208,650,558,8,8,394,226,168,626,531,95,7
2021,Birmingham 064,E02001890,4406,1663,896,767,13,13,713,216,497,2008,1920,88,9
2021,Birmingham 066,E02001892,3468,1641,732,909,13,13,1111,957,154,677,608,69,26
2021,Birmingham 067,E02001893,3159,2091,1121,970,9,9,448,298,150,597,534,63,14
2021,Birmingham 069,E02001895,3536,1785,869,916,33,33,1226,1009,217,472,430,42,20
2021,Birmingham 070,E02001896,2571,1242,765,477,5,5,438,95,343,881,754,127,5
2021,Birmingham 071,E02001897,2887,754,441,313,17,17,1640,1006,634,444,372,72,32
2021,Birmingham 072,E02001898,2632,2147,1128,1019,10,10,124,74,50,349,295,54,2
2021,Birmingham 073,E02001899,3548,2587,1419,1168,106,106,283,57,226,567,500,67,5
2021,Birmingham 074,E02001900,2739,975,563,412,15,15,1042,527,515,692,651,41,15
2021,Birmingham 075,E02001901,3750,2163,1051,1112,27,27,366,136,230,1192,1132,60,2
2021,Birmingham 076,E02001902,2463,1644,800,844,11,11,290,232,58,515,466,49,3
2021,Birmingham 077,E02001903,2120,950,639,311,6,6,719,192,527,441,356,85,4
2021,Birmingham 078,E02001904,2622,1269,548,721,6,6,484,329,155,850,783,67,13
2021,Birmingham 079,E02001905,2647,1463,825,638,11,11,145,39,106,1025,915,110,3
2021,Birmingham 080,E02001906,3877,2690,1393,1297,19,19,494,379,115,667,600,67,7
2021,Birmingham 081,E02001907,4396,3080,1591,1489,25,25,448,387,61,836,774,62,7
2021,Birmingham 082,E02001908,2211,1234,770,464,3,3,337,119,218,632,523,109,5
2021,Birmingham 083,E02001909,2366,992,593,399,5,5,724,182,542,643,569,74,2
2021,Birmingham 084,E02001910,2343,923,609,314,8,8,890,327,563,511,464,47,11
2021,Birmingham 085,E02001911,3533,1421,711,710,28,28,1498,1320,178,539,493,46,47
2021,Birmingham 087,E02001913,3174,1076,627,449,19,19,982,724,258,1081,1029,52,16
2021,Birmingham 088,E02001914,2315,1374,762,612,14,14,372,127,245,554,503,51,1
2021,Birmingham 089,E02001915,4918,2577,1237,1340,53,53,931,410,521,1336,1242,94,21
2021,Birmingham 090,E02001916,3375,1843,817,1026,30,30,651,490,161,834,742,92,17
2021,Birmingham 092,E02001918,3976,1726,888,838,25,25,988,144,844,1231,1146,85,6
2021,Birmingham 093,E02001919,2620,1499,860,639,5,5,270,32,238,844,769,75,2
2021,Birmingham 094,E02001920,3238,1583,840,743,15,15,1180,1118,62,440,400,40,20
2021,Birmingham 095,E02001921,3181,1687,863,824,14,14,842,722,120,626,576,50,12
2021,Birmingham 096,E02001922,3502,531,285,246,59,59,460,198,262,2446,2383,63,6
2021,Birmingham 097,E02001923,3368,2261,1230,1031,12,12,365,137,228,727,645,82,3
2021,Birmingham 098,E02001924,2499,1581,723,858,20,20,485,396,89,402,357,45,11
2021,Birmingham 099,E02001925,2839,1638,940,698,6,6,571,177,394,621,558,63,3
2021,Birmingham 100,E02001926,3092,1679,848,831,31,31,406,119,287,974,899,75,2
2021,Birmingham 101,E02001927,3011,1444,664,780,48,48,962,726,236,542,499,43,15
2021,Birmingham 102,E02001928,3001,1505,821,684,27,27,1155,937,218,298,261,37,16
2021,Birmingham 103,E02001929,3729,1776,732,1044,6,6,1170,1075,95,751,691,60,26
2021,Birmingham 104,E02001930,3210,2158,1104,1054,5,5,288,170,118,755,682,73,4
2021,Birmingham 105,E02001931,3169,2257,1267,990,10,10,366,231,135,530,442,88,6
2021,Birmingham 106,E02001932,3073,1268,573,695,122,122,1317,907,410,348,291,57,18
2021,Birmingham 107,E02001933,3155,1962,947,1015,15,15,614,444,170,555,485,70,9
2021,Birmingham 108,E02001934,2290,1791,957,834,10,10,112,91,21,377,331,46,0
2021,Birmingham 109,E02001935,3279,1880,1095,785,39,39,967,193,774,388,338,50,5
2021,Birmingham 110,E02001936,2553,1921,1077,844,10,10,322,242,80,292,251,41,8
2021,Birmingham 111,E02001937,3260,1686,821,865,57,57,983,839,144,519,464,55,15
2021,Birmingham 112,E02001938,3512,2053,883,1170,38,38,512,97,415,908,819,89,1
2021,Birmingham 113,E02001939,3102,1086,664,422,101,101,1579,442,1137,331,293,38,5
2021,Birmingham 115,E02001941,2524,1331,645,686,22,22,727,634,93,429,377,52,15
2021,Birmingham 116,E02001942,3007,1653,919,734,62,62,674,400,274,611,560,51,7
2021,Birmingham 117,E02001943,2642,1643,825,818,79,79,502,299,203,406,366,40,12
2021,Birmingham 118,E02001944,3414,2183,1021,1162,115,115,595,351,244,509,455,54,12
2021,Birmingham 119,E02001945,3053,1410,621,789,50,50,1071,976,95,503,459,44,19
2021,Birmingham 120,E02001946,3209,2386,1311,1075,25,25,320,153,167,474,413,61,4
2021,Birmingham 121,E02001947,2662,1025,569,456,7,7,1332,1217,115,260,223,37,38
2021,Birmingham 122,E02001948,3050,2183,1074,1109,22,22,354,278,76,479,423,56,12
2021,Birmingham 123,E02001949,2653,1521,721,800,30,30,630,412,218,465,415,50,7
2021,Birmingham 124,E02001950,3705,2553,1332,1221,41,41,460,268,192,641,591,50,10
2021,Birmingham 125,E02001951,3914,1618,713,905,41,41,1821,1623,198,408,341,67,26
2021,Birmingham 126,E02001952,4100,1460,755,705,105,105,1956,1374,582,549,485,64,30
2021,Birmingham 127,E02001953,2922,2129,1148,981,17,17,435,373,62,327,278,49,14
2021,Birmingham 128,E02001954,3258,1305,618,687,19,19,1537,1395,142,366,317,49,31
2021,Birmingham 129,E02001955,3537,1833,791,1042,178,178,903,431,472,606,567,39,17
2021,Birmingham 130,E02001956,2848,1924,902,1022,32,32,401,307,94,482,424,58,9
2021,Birmingham 131,E02001957,3349,2458,1252,1206,23,23,362,202,160,500,451,49,6
2021,Coventry 001,E02001958,3401,1930,975,955,53,53,479,70,409,936,856,80,3
2021,Coventry 002,E02001959,2581,1882,999,883,17,17,117,22,95,563,498,65,2
2021,Coventry 004,E02001961,3267,1459,722,737,32,32,1138,438,700,633,568,65,5
2021,Coventry 005,E02001962,2496,1441,600,841,10,10,328,81,247,713,644,69,4
2021,Coventry 006,E02001963,2536,1830,1005,825,5,5,324,111,213,373,299,74,4
2021,Coventry 007,E02001964,4132,1566,558,1008,39,39,1990,857,1133,500,426,74,37
2021,Coventry 008,E02001965,3387,2186,1203,983,71,71,479,64,415,649,563,86,2
2021,Coventry 009,E02001966,2249,931,514,417,36,36,439,109,330,840,757,83,3
2021,Coventry 010,E02001967,2868,2339,1299,1040,5,5,177,76,101,344,280,64,3
2021,Coventry 011,E02001968,2894,1723,795,928,30,30,185,56,129,950,863,87,6
2021,Coventry 012,E02001969,2685,1437,733,704,11,11,458,177,281,774,720,54,5
2021,Coventry 013,E02001970,2537,1827,1053,774,5,5,160,61,99,544,475,69,1
2021,Coventry 014,E02001971,2485,1867,959,908,10,10,193,74,119,413,369,44,2
2021,Coventry 015,E02001972,4063,1350,716,634,22,22,1201,284,917,1479,1341,138,11
2021,Coventry 016,E02001973,3491,1586,794,792,11,11,902,369,533,989,923,66,3
2021,Coventry 017,E02001974,3944,3022,1552,1470,24,24,89,23,66,807,720,87,2
2021,Coventry 018,E02001975,2903,2173,1062,1111,7,7,74,26,48,646,585,61,3
2021,Coventry 019,E02001976,3126,1718,978,740,19,19,596,190,406,791,716,75,2
2021,Coventry 020,E02001977,4188,1203,581,622,20,20,994,308,686,1956,1836,120,15
2021,Coventry 021,E02001978,2584,1674,890,784,8,8,87,19,68,814,763,51,1
2021,Coventry 022,E02001979,2415,2041,1114,927,7,7,50,15,35,317,272,45,0
2021,Coventry 023,E02001980,2568,2225,1382,843,1,1,37,11,26,305,269,36,0
2021,Coventry 024,E02001981,4361,968,552,416,17,17,1544,434,1110,1816,1667,149,16
2021,Coventry 025,E02001982,3584,2459,1114,1345,51,51,478,71,407,595,536,59,1
2021,Coventry 026,E02001983,3248,2341,1179,1162,11,11,293,96,197,601,515,86,2
2021,Coventry 027,E02001984,3955,2598,1196,1402,38,38,321,90,231,990,889,101,8
2021,Coventry 028,E02001985,3087,676,443,233,13,13,481,117,364,1907,1804,103,10
2021,Coventry 029,E02001986,3656,1743,933,810,19,19,1326,501,825,565,506,59,3
2021,Coventry 030,E02001987,2778,1161,633,528,108,108,193,27,166,1314,1223,91,2
2021,Coventry 031,E02001988,3442,799,439,360,16,16,1077,258,819,1539,1468,71,11
2021,Coventry 032,E02001989,2529,1726,850,876,21,21,188,67,121,593,539,54,1
2021,Coventry 033,E02001990,3710,3058,1664,1394,19,19,137,35,102,496,435,61,0
2021,Coventry 034,E02001991,3625,2702,1620,1082,10,10,176,30,146,735,666,69,2
2021,Coventry 035,E02001992,4181,2056,962,1094,28,28,1556,559,997,532,477,55,9
2021,Coventry 036,E02001993,3314,1583,820,763,27,27,1026,322,704,668,604,64,10
2021,Coventry 037,E02001994,3251,2175,1185,990,5,5,355,117,238,714,630,84,2
2021,Coventry 038,E02001995,4001,2095,946,1149,16,16,406,80,326,1480,1395,85,4
2021,Coventry 039,E02001996,3329,1208,568,640,14,14,1666,653,1013,432,380,52,9
2021,Coventry 040,E02001997,3410,2836,1723,1113,6,6,213,76,137,354,293,61,1
2021,Coventry 041,E02001998,2368,2039,1170,869,7,7,38,15,23,283,239,44,1
2021,Coventry 042,E02001999,2192,1553,975,578,14,14,173,57,116,449,404,45,3
2021,Dudley 001,E02002000,3631,1986,1102,884,15,15,1210,888,322,404,341,63,16
2021,Dudley 002,E02002001,2592,1666,911,755,7,7,578,495,83,337,289,48,4
2021,Dudley 003,E02002002,3028,2606,1729,877,11,11,221,167,54,186,146,40,4
2021,Dudley 004,E02002003,3819,2734,1625,1109,10,10,605,520,85,463,390,73,7
2021,Dudley 005,E02002004,3121,1774,955,819,52,52,945,715,230,337,283,54,13
2021,Dudley 006,E02002005,3622,1717,809,908,14,14,1462,1208,254,416,368,48,13
2021,Dudley 007,E02002006,2894,1625,844,781,31,31,903,637,266,321,282,39,14
2021,Dudley 008,E02002007,3972,2974,1818,1156,4,4,614,544,70,368,292,76,12
2021,Dudley 009,E02002008,3198,2673,1378,1295,17,17,99,47,52,409,368,41,0
2021,Dudley 010,E02002009,2635,1175,574,601,5,5,938,837,101,494,456,38,23
2021,Dudley 011,E02002010,3623,1417,799,618,41,41,1078,725,353,1069,997,72,18
2021,Dudley 012,E02002011,2603,2216,1357,859,10,10,106,74,32,269,225,44,2
2021,Dudley 013,E02002012,3615,1591,893,698,24,24,1507,1230,277,468,391,77,25
2021,Dudley 014,E02002013,2819,2409,1517,892,5,5,209,203,6,190,160,30,6
2021,Dudley 015,E02002014,3166,1553,789,764,11,11,704,524,180,881,812,69,17
2021,Dudley 016,E02002015,2946,2119,1083,1036,28,28,391,332,59,399,366,33,9
2021,Dudley 017,E02002016,3318,1556,835,721,5,5,1213,1107,106,518,458,60,26
2021,Dudley 018,E02002017,3420,1959,1126,833,14,14,745,598,147,670,601,69,32
2021,Dudley 019,E02002018,3706,3219,1975,1244,7,7,234,221,13,243,196,47,3
2021,Dudley 020,E02002019,3093,1793,1012,781,4,4,877,836,41,405,360,45,14
2021,Dudley 021,E02002020,4224,3325,1887,1438,11,11,293,231,62,588,526,62,7
2021,Dudley 022,E02002021,3737,1366,694,672,15,15,1369,1114,255,971,883,88,16
2021,Dudley 023,E02002022,3722,2201,963,1238,5,5,931,823,108,570,518,52,15
2021,Dudley 024,E02002023,2332,1820,1059,761,2,2,259,166,93,249,215,34,2
2021,Dudley 025,E02002024,3646,2509,1278,1231,18,18,615,519,96,493,416,77,11
2021,Dudley 026,E02002025,3672,2454,1200,1254,31,31,519,369,150,661,583,78,7
2021,Dudley 027,E02002026,2865,2395,1374,1021,59,59,146,135,11,262,230,32,3
2021,Dudley 028,E02002027,2247,1947,1054,893,27,27,31,20,11,241,214,27,1
2021,Dudley 029,E02002028,2625,1953,1169,784,5,5,407,372,35,249,195,54,11
2021,Dudley 030,E02002029,2591,2075,1213,862,3,3,186,106,80,327,273,54,0
2021,Dudley 031,E02002030,3026,1872,991,881,36,36,729,475,254,375,322,53,14
2021,Dudley 032,E02002031,2560,1728,963,765,17,17,208,81,127,606,528,78,1
2021,Dudley 033,E02002032,4267,2560,1233,1327,21,21,979,817,162,692,626,66,15
2021,Dudley 034,E02002033,3302,2458,1397,1061,19,19,405,237,168,416,357,59,4
2021,Dudley 035,E02002034,3900,2401,1268,1133,7,7,732,687,45,754,678,76,6
2021,Dudley 036,E02002035,2511,2128,1299,829,2,2,206,190,16,171,135,36,4
2021,Dudley 037,E02002036,2878,1396,788,608,2,2,900,793,107,560,496,64,20
2021,Dudley 038,E02002037,2541,1937,1107,830,3,3,371,357,14,219,192,27,11
2021,Dudley 039,E02002038,4416,2746,1505,1241,5,5,1014,854,160,638,564,74,13
2021,Dudley 040,E02002039,2655,1901,1105,796,4,4,300,256,44,445,397,48,5
2021,Dudley 041,E02002040,2555,2205,1412,793,6,6,176,118,58,168,131,37,0
2021,Dudley 042,E02002041,2634,2054,1358,696,2,2,384,377,7,192,167,25,2
2021,Dudley 043,E02002042,3340,2855,1685,1170,3,3,229,156,73,249,217,32,4
2021,Sandwell 001,E02002043,3223,1862,939,923,1,1,874,786,88,473,427,46,13
2021,Sandwell 002,E02002044,2941,1642,736,906,23,23,778,553,225,492,446,46,6
2021,Sandwell 003,E02002045,3186,1927,1020,907,11,11,871,787,84,360,309,51,17
2021,Sandwell 004,E02002046,2052,835,418,417,6,6,1003,994,9,188,170,18,20
2021,Sandwell 005,E02002047,3091,1600,951,649,15,15,897,682,215,561,514,47,18
2021,Sandwell 006,E02002048,2719,2207,1282,925,3,3,125,86,39,382,337,45,2
2021,Sandwell 007,E02002049,2505,1484,837,647,14,14,674,516,158,321,289,32,12
2021,Sandwell 009,E02002051,2240,916,458,458,5,5,1048,830,218,258,225,33,13
2021,Sandwell 010,E02002052,4236,2037,991,1046,6,6,1453,1135,318,715,640,75,25
2021,Sandwell 011,E02002053,2538,1741,978,763,0,0,393,338,55,399,361,38,5
2021,Sandwell 012,E02002054,2316,1712,955,757,2,2,248,215,33,350,318,32,4
2021,Sandwell 013,E02002055,4182,2109,1004,1105,35,35,1294,778,516,726,598,128,18
2021,Sandwell 014,E02002056,3857,1606,751,855,9,9,1724,1560,164,494,449,45,24
2021,Sandwell 015,E02002057,4278,2069,982,1087,48,48,1364,974,390,754,675,79,43
2021,Sandwell 016,E02002058,4974,2587,1054,1533,16,16,1344,1192,152,1008,925,83,19
2021,Sandwell 017,E02002059,4573,2221,1212,1009,16,16,1411,1127,284,906,812,94,19
2021,Sandwell 018,E02002060,2632,1232,645,587,18,18,921,774,147,448,410,38,13
2021,Sandwell 019,E02002061,2426,1002,567,435,38,38,649,432,217,720,631,89,17
2021,Sandwell 020,E02002062,3492,1212,599,613,20,20,1544,856,688,660,577,83,56
2021,Sandwell 021,E02002063,3936,2239,968,1271,15,15,643,393,250,1037,973,64,2
2021,Sandwell 022,E02002064,4819,2882,1430,1452,11,11,1183,1114,69,717,635,82,26
2021,Sandwell 023,E02002065,4143,2076,1039,1037,23,23,772,443,329,1229,1058,171,43
2021,Sandwell 024,E02002066,2923,1411,727,684,6,6,645,446,199,847,750,97,14
2021,Sandwell 025,E02002067,2506,1663,928,735,9,9,488,418,70,328,301,27,18
2021,Sandwell 027,E02002069,3168,1593,823,770,16,16,1044,938,106,490,440,50,25
2021,Sandwell 028,E02002070,3597,1384,789,595,26,26,1104,655,449,1048,940,108,35
2021,Sandwell 029,E02002071,2733,1507,793,714,9,9,886,808,78,317,292,25,14
2021,Sandwell 030,E02002072,3605,2240,1151,1089,16,16,594,457,137,742,658,84,13
2021,Sandwell 031,E02002073,2934,1595,835,760,10,10,918,849,69,383,324,59,28
2021,Sandwell 032,E02002074,3164,1962,1011,951,12,12,758,730,28,411,357,54,21
2021,Sandwell 033,E02002075,3684,2148,1077,1071,24,24,934,692,242,565,482,83,13
2021,Sandwell 034,E02002076,4535,2561,1260,1301,21,21,404,361,43,1539,1432,107,10
2021,Sandwell 035,E02002077,4514,2358,1245,1113,32,32,1312,1028,284,777,721,56,35
2021,Sandwell 036,E02002078,2592,2003,1160,843,8,8,243,194,49,336,293,43,2
2021,Sandwell 037,E02002079,3533,2205,1069,1136,51,51,755,668,87,503,434,69,19
2021,Sandwell 038,E02002080,3087,1712,873,839,19,19,812,682,130,525,485,40,19
2021,Solihull 001,E02002081,2363,1745,1051,694,19,19,385,88,297,214,181,33,0
2021,Solihull 002,E02002082,2318,1083,547,536,10,10,889,711,178,323,286,37,13
2021,Solihull 003,E02002083,2415,2169,1198,971,31,31,41,21,20,174,150,24,0
2021,Solihull 004,E02002084,2756,1380,674,706,16,16,1085,791,294,268,231,37,7
2021,Solihull 005,E02002085,2654,1490,727,763,20,20,813,675,138,327,295,32,4
2021,Solihull 006,E02002086,2651,1009,462,547,10,10,1354,1044,310,271,244,27,7
2021,Solihull 007,E02002087,2683,1186,574,612,10,10,1088,970,118,392,351,41,7
2021,Solihull 008,E02002088,4139,1756,896,860,29,29,1737,1404,333,609,561,48,8
2021,Solihull 009,E02002089,3253,2332,1215,1117,48,48,419,192,227,447,407,40,7
2021,Solihull 010,E02002090,2321,1941,933,1008,14,14,67,48,19,299,271,28,0
2021,Solihull 011,E02002091,3126,2470,1314,1156,10,10,196,136,60,449,388,61,1
2021,Solihull 012,E02002092,3043,2056,1041,1015,16,16,577,506,71,391,345,46,3
2021,Solihull 013,E02002093,2946,1924,1026,898,20,20,421,265,156,577,528,49,4
2021,Solihull 014,E02002094,2396,2133,1276,857,3,3,27,20,7,232,200,32,1
2021,Solihull 015,E02002095,3632,2640,1468,1172,26,26,292,221,71,671,605,66,3
2021,Solihull 016,E02002096,4277,3196,1900,1296,44,44,364,266,98,668,611,57,5
2021,Solihull 017,E02002097,3120,2391,1324,1067,23,23,365,204,161,335,269,66,6
2021,Solihull 018,E02002098,3904,3011,1641,1370,16,16,421,283,138,452,405,47,4
2021,Solihull 019,E02002099,2807,2281,1397,884,12,12,86,20,66,427,403,24,1
2021,Solihull 021,E02002101,2860,2070,1118,952,39,39,361,173,188,388,342,46,2
2021,Solihull 022,E02002102,3528,2712,1429,1283,17,17,283,172,111,513,454,59,3
2021,Solihull 023,E02002103,2541,2144,1252,892,3,3,205,188,17,186,151,35,3
2021,Solihull 024,E02002104,2377,2088,1265,823,4,4,20,4,16,265,243,22,0
2021,Solihull 025,E02002105,3340,2810,1588,1222,18,18,138,74,64,371,320,51,3
2021,Solihull 026,E02002106,4084,3414,2092,1322,29,29,215,105,110,422,368,54,4
2021,Solihull 027,E02002107,2253,1905,1073,832,23,23,50,42,8,271,247,24,4
2021,Solihull 028,E02002108,3980,3403,1984,1419,12,12,197,115,82,367,320,47,1
2021,Solihull 029,E02002109,5049,3751,1591,2160,153,153,319,89,230,824,743,81,2
2021,Walsall 001,E02002110,2831,1915,906,1009,49,49,511,192,319,353,302,51,3
2021,Walsall 002,E02002111,2763,1552,880,672,16,16,937,322,615,251,209,42,7
2021,Walsall 003,E02002112,2211,1649,959,690,5,5,354,150,204,199,172,27,4
2021,Walsall 004,E02002113,2691,1721,892,829,30,30,532,213,319,399,340,59,9
2021,Walsall 005,E02002114,2681,1955,1211,744,11,11,373,106,267,340,296,44,2
2021,Walsall 006,E02002115,2838,1655,963,692,8,8,881,389,492,292,257,35,2
2021,Walsall 007,E02002116,2909,2314,1362,952,7,7,315,143,172,272,215,57,1
2021,Walsall 008,E02002117,2780,1695,998,697,3,3,726,247,479,350,277,73,6
2021,Walsall 009,E02002118,3031,1501,814,687,12,12,1067,492,575,444,392,52,7
2021,Walsall 010,E02002119,2442,1709,917,792,24,24,417,157,260,290,249,41,2
2021,Walsall 011,E02002120,2357,1787,989,798,34,34,316,153,163,218,188,30,2
2021,Walsall 012,E02002121,2561,1138,545,593,10,10,960,398,562,450,400,50,3
2021,Walsall 013,E02002122,2494,1103,444,659,9,9,945,453,492,434,399,35,3
2021,Walsall 014,E02002123,2693,1644,907,737,5,5,654,290,364,386,342,44,4
2021,Walsall 015,E02002124,3190,2086,1247,839,12,12,664,249,415,425,365,60,3
2021,Walsall 016,E02002125,2745,1726,820,906,23,23,617,215,402,374,317,57,5
2021,Walsall 017,E02002126,2733,924,500,424,1,1,1357,330,1027,449,413,36,2
2021,Walsall 018,E02002127,3443,1489,652,837,28,28,1202,495,707,716,662,54,8
2021,Walsall 019,E02002128,2424,1599,1002,597,12,12,514,230,284,298,279,19,1
2021,Walsall 020,E02002129,2568,1889,1121,768,4,4,326,166,160,345,300,45,4
2021,Walsall 021,E02002130,2583,1171,604,567,12,12,913,101,812,483,443,40,4
2021,Walsall 022,E02002131,3182,2798,1628,1170,4,4,154,52,102,226,177,49,0
2021,Walsall 023,E02002132,2577,1337,741,596,2,2,940,437,503,294,256,38,4
2021,Walsall 024,E02002133,3056,1619,936,683,33,33,818,129,689,583,531,52,3
2021,Walsall 025,E02002134,3617,1829,894,935,31,31,939,402,537,815,751,64,3
2021,Walsall 026,E02002135,2924,1154,618,536,8,8,878,272,606,876,803,73,8
2021,Walsall 027,E02002136,3261,1575,772,803,17,17,790,349,441,873,809,64,6
2021,Walsall 028,E02002137,2568,2313,1407,906,6,6,39,16,23,209,178,31,1
2021,Walsall 029,E02002138,2258,1619,886,733,7,7,116,17,99,516,460,56,0
2021,Walsall 030,E02002139,4313,1275,726,549,15,15,1662,256,1406,1350,1235,115,11
2021,Walsall 031,E02002140,2960,1354,772,582,7,7,747,238,509,838,750,88,14
2021,Walsall 032,E02002141,2601,2280,1233,1047,8,8,87,39,48,226,204,22,0
2021,Walsall 033,E02002142,2718,1206,641,565,23,23,940,250,690,544,482,62,5
2021,Walsall 034,E02002143,3131,1471,810,661,12,12,757,194,563,882,799,83,9
2021,Walsall 035,E02002144,2473,2191,1316,875,5,5,74,10,64,203,158,45,0
2021,Walsall 036,E02002145,3268,1404,643,761,12,12,1177,383,794,668,613,55,7
2021,Walsall 037,E02002146,2179,1352,670,682,12,12,434,116,318,379,339,40,2
2021,Walsall 038,E02002147,3480,1640,782,858,16,16,1253,538,715,562,506,56,9
2021,Walsall 039,E02002148,4694,3950,2086,1864,28,28,192,56,136,524,455,69,0
2021,Wolverhampton 001,E02002149,4270,2827,1574,1253,18,18,910,725,185,505,446,59,10
2021,Wolverhampton 002,E02002150,2260,1423,693,730,15,15,484,435,49,332,306,26,6
2021,Wolverhampton 003,E02002151,2459,1140,546,594,27,27,905,692,213,373,341,32,14
2021,Wolverhampton 004,E02002152,2307,1064,523,541,7,7,995,896,99,228,196,32,13
2021,Wolverhampton 005,E02002153,3352,2006,1121,885,3,3,933,868,65,391,334,57,19
2021,Wolverhampton 006,E02002154,2939,1863,683,1180,15,15,581,362,219,472,421,51,8
2021,Wolverhampton 007,E02002155,2347,665,324,341,11,11,1358,1016,342,307,280,27,6
2021,Wolverhampton 008,E02002156,3333,2243,1170,1073,15,15,596,491,105,464,395,69,15
2021,Wolverhampton 009,E02002157,3182,2428,1310,1118,12,12,234,170,64,505,463,42,3
2021,Wolverhampton 010,E02002158,3281,2106,1246,860,3,3,795,722,73,363,275,88,14
2021,Wolverhampton 011,E02002159,2232,940,462,478,8,8,734,605,129,540,484,56,10
2021,Wolverhampton 012,E02002160,2932,2003,1106,897,10,10,409,330,79,510,463,47,0
2021,Wolverhampton 013,E02002161,2549,1142,517,625,23,23,681,363,318,695,632,63,8
2021,Wolverhampton 014,E02002162,3364,2548,1576,972,40,40,331,273,58,428,373,55,17
2021,Wolverhampton 015,E02002163,5014,1433,780,653,33,33,2482,1806,676,1049,919,130,17
2021,Wolverhampton 016,E02002164,2361,527,331,196,8,8,985,437,548,831,777,54,10
2021,Wolverhampton 017,E02002165,3655,1356,792,564,14,14,626,223,403,1643,1526,117,16
2021,Wolverhampton 018,E02002166,3808,1661,924,737,13,13,1526,1232,294,586,539,47,22
2021,Wolverhampton 019,E02002167,2958,2089,1213,876,7,7,435,403,32,417,367,50,10
2021,Wolverhampton 020,E02002168,4637,1350,765,585,39,39,1329,695,634,1894,1767,127,25
2021,Wolverhampton 021,E02002169,3561,2882,1713,1169,14,14,197,146,51,460,399,61,8
2021,Wolverhampton 022,E02002170,2414,1448,841,607,4,4,597,456,141,353,299,54,12
2021,Wolverhampton 023,E02002171,3103,1685,962,723,9,9,920,844,76,468,418,50,21
2021,Wolverhampton 026,E02002174,3012,2258,1195,1063,4,4,220,88,132,526,467,59,4
2021,Wolverhampton 027,E02002175,3067,1220,683,537,5,5,1140,823,317,683,610,73,19
2021,Wolverhampton 028,E02002176,3313,2004,1060,944,16,16,918,789,129,361,312,49,14
2021,Wolverhampton 029,E02002177,4535,2106,898,1208,24,24,1372,1012,360,1009,931,78,24
2021,Wolverhampton 030,E02002178,2744,2122,1323,799,7,7,68,47,21,546,464,82,1
2021,Wolverhampton 031,E02002179,2607,2126,1200,926,3,3,142,92,50,332,293,39,4
2021,Wolverhampton 032,E02002180,2591,1754,1047,707,6,6,476,451,25,342,300,42,13
2021,Wolverhampton 033,E02002181,3368,1702,756,946,6,6,1152,1005,147,494,451,43,14
2021,Wolverhampton 034,E02002182,2481,1556,864,692,7,7,605,521,84,305,264,41,8
2021,Bradford 001,E02002183,2759,2221,1481,740,19,19,200,70,130,319,270,49,0
2021,Bradford 002,E02002184,5831,4488,2823,1665,38,38,446,171,275,856,757,99,3
2021,Bradford 003,E02002185,2512,2002,1091,911,22,22,208,72,136,277,246,31,3
2021,Bradford 005,E02002187,2614,2222,1262,960,16,16,125,31,94,251,211,40,0
2021,Bradford 006,E02002188,3192,2661,1361,1300,39,39,43,17,26,448,393,55,1
2021,Bradford 007,E02002189,2274,1672,941,731,7,7,111,43,68,481,417,64,3
2021,Bradford 008,E02002190,4262,2430,1408,1022,14,14,443,143,300,1370,1208,162,5
2021,Bradford 009,E02002191,3703,1939,911,1028,13,13,824,401,423,916,821,95,11
2021,Bradford 010,E02002192,4021,3259,1877,1382,17,17,268,117,151,477,410,67,0
2021,Bradford 011,E02002193,3087,1320,682,638,6,6,829,298,531,925,871,54,7
2021,Bradford 012,E02002194,3194,2103,1115,988,18,18,623,303,320,434,369,65,16
2021,Bradford 013,E02002195,2870,2367,1398,969,16,16,175,59,116,311,254,57,1
2021,Bradford 014,E02002196,2710,2026,994,1032,31,31,201,109,92,452,404,48,0
2021,Bradford 015,E02002197,4154,2513,1257,1256,18,18,537,177,360,1080,987,93,6
2021,Bradford 016,E02002198,3946,2731,1406,1325,7,7,566,268,298,632,539,93,10
2021,Bradford 017,E02002199,3267,2489,1168,1321,36,36,234,47,187,508,456,52,0
2021,Bradford 018,E02002200,3965,2896,1586,1310,35,35,316,117,199,716,632,84,2
2021,Bradford 019,E02002201,5430,3526,1486,2040,74,74,936,365,571,889,789,100,5
2021,Bradford 020,E02002202,3778,1821,918,903,22,22,635,290,345,1297,1186,111,3
2021,Bradford 021,E02002203,3532,1981,920,1061,27,27,864,435,429,652,560,92,8
2021,Bradford 022,E02002204,5071,3975,2193,1782,15,15,370,121,249,710,602,108,1
2021,Bradford 023,E02002205,4569,3440,1958,1482,30,30,173,45,128,925,795,130,1
2021,Bradford 024,E02002206,3566,2487,1266,1221,22,22,451,211,240,604,512,92,2
2021,Bradford 025,E02002207,2392,1557,812,745,14,14,161,57,104,659,572,87,1
2021,Bradford 026,E02002208,3501,2001,951,1050,46,46,650,254,396,799,732,67,5
2021,Bradford 027,E02002209,2599,1187,497,690,3,3,961,517,444,446,406,40,2
2021,Bradford 028,E02002210,2849,2062,1039,1023,6,6,142,34,108,639,522,117,0
2021,Bradford 029,E02002211,2103,1491,775,716,13,13,133,13,120,465,388,77,1
2021,Bradford 030,E02002212,2728,1551,570,981,12,12,525,213,312,632,564,68,8
2021,Bradford 031,E02002213,3381,2430,1223,1207,11,11,390,103,287,547,474,73,3
2021,Bradford 032,E02002214,2540,1859,794,1065,27,27,81,20,61,573,485,88,0
2021,Bradford 033,E02002215,2881,1703,919,784,5,5,289,65,224,884,769,115,0
2021,Bradford 034,E02002216,2945,1287,791,496,8,8,792,183,609,853,731,122,5
2021,Bradford 035,E02002217,3312,1603,801,802,7,7,549,163,386,1145,1042,103,8
2021,Bradford 036,E02002218,3899,2321,1068,1253,9,9,831,371,460,731,643,88,7
2021,Bradford 037,E02002219,2247,1238,620,618,16,16,204,63,141,785,682,103,4
2021,Bradford 038,E02002220,2612,1542,760,782,4,4,443,258,185,618,522,96,5
2021,Bradford 040,E02002222,3096,1760,776,984,21,21,586,245,341,729,667,62,0
2021,Bradford 041,E02002223,2275,1046,582,464,7,7,337,84,253,882,772,110,3
2021,Bradford 042,E02002224,2913,1569,957,612,13,13,431,104,327,892,763,129,8
2021,Bradford 043,E02002225,3648,2501,1218,1283,10,10,382,148,234,755,652,103,0
2021,Bradford 044,E02002226,3744,1728,1126,602,11,11,259,31,228,1725,1561,164,21
2021,Bradford 045,E02002227,2333,765,435,330,3,3,746,212,534,814,741,73,5
2021,Bradford 046,E02002228,3080,1207,588,619,5,5,1119,288,831,747,688,59,2
2021,Bradford 047,E02002229,3302,2155,1078,1077,23,23,438,169,269,685,591,94,1
2021,Bradford 048,E02002230,2808,941,575,366,18,18,727,159,568,1113,980,133,9
2021,Bradford 049,E02002231,4549,2916,1424,1492,11,11,567,217,350,1050,931,119,5
2021,Bradford 050,E02002232,2594,1247,610,637,2,2,391,93,298,951,864,87,3
2021,Bradford 051,E02002233,2754,1359,737,622,7,7,732,340,392,655,568,87,1
2021,Bradford 052,E02002234,3199,873,384,489,6,6,1724,907,817,586,516,70,10
2021,Bradford 053,E02002235,2354,1221,681,540,13,13,471,148,323,644,550,94,5
2021,Bradford 054,E02002236,2558,1799,866,933,26,26,96,28,68,637,551,86,0
2021,Bradford 055,E02002237,3348,2211,983,1228,17,17,288,167,121,830,744,86,2
2021,Bradford 056,E02002238,2595,1360,640,720,10,10,579,243,336,640,544,96,6
2021,Bradford 057,E02002239,4338,2564,1102,1462,17,17,724,271,453,1031,933,98,2
2021,Bradford 058,E02002240,4983,3660,1691,1969,26,26,361,148,213,934,811,123,2
2021,Bradford 059,E02002241,5081,3076,1284,1792,9,9,949,482,467,1039,925,114,8
2021,Bradford 060,E02002242,3512,2600,1353,1247,4,4,310,87,223,598,496,102,0
2021,Bradford 061,E02002243,4182,2612,1308,1304,12,12,717,369,348,838,763,75,3
2021,Calderdale 001,E02002244,2640,1925,1044,881,28,28,337,117,220,349,288,61,1
2021,Calderdale 002,E02002245,2257,1035,523,512,3,3,750,318,432,467,427,40,2
2021,Calderdale 003,E02002246,4278,3389,1888,1501,8,8,268,57,211,611,516,95,2
2021,Calderdale 004,E02002247,4281,3079,1846,1233,43,43,385,77,308,773,687,86,1
2021,Calderdale 005,E02002248,3345,1879,910,969,4,4,837,289,548,621,511,110,4
2021,Calderdale 006,E02002249,2403,1103,503,600,9,9,725,283,442,566,510,56,0
2021,Calderdale 007,E02002250,3864,2685,1582,1103,9,9,510,124,386,659,563,96,1
2021,Calderdale 008,E02002251,4261,1715,940,775,14,14,1027,261,766,1499,1384,115,6
2021,Calderdale 009,E02002252,2815,2075,1070,1005,5,5,361,74,287,372,312,60,2
2021,Calderdale 010,E02002253,2998,1701,781,920,6,6,389,109,280,895,775,120,7
2021,Calderdale 011,E02002254,2712,2131,1133,998,8,8,171,28,143,402,344,58,0
2021,Calderdale 012,E02002255,2408,1030,655,375,3,3,698,140,558,672,573,99,5
2021,Calderdale 013,E02002256,4237,2592,1380,1212,36,36,675,198,477,930,835,95,4
2021,Calderdale 014,E02002257,2140,1238,666,572,4,4,170,27,143,722,626,96,6
2021,Calderdale 015,E02002258,4048,2718,1419,1299,14,14,514,168,346,802,721,81,0
2021,Calderdale 016,E02002259,3124,2107,1098,1009,11,11,241,22,219,762,677,85,3
2021,Calderdale 017,E02002260,4347,2564,1319,1245,24,24,722,181,541,1035,926,109,2
2021,Calderdale 018,E02002261,3651,2329,1191,1138,5,5,476,147,329,838,743,95,3
2021,Calderdale 019,E02002262,3711,2452,1431,1021,6,6,508,177,331,744,662,82,1
2021,Calderdale 020,E02002263,2806,1826,930,896,6,6,548,179,369,422,368,54,4
2021,Calderdale 021,E02002264,3084,2306,1286,1020,13,13,195,18,177,569,498,71,1
2021,Calderdale 022,E02002265,2608,1771,948,823,7,7,313,64,249,516,451,65,1
2021,Calderdale 023,E02002266,2568,1896,1108,788,7,7,230,74,156,435,393,42,0
2021,Calderdale 024,E02002267,3531,2379,1241,1138,12,12,701,257,444,433,363,70,6
2021,Calderdale 025,E02002268,4663,2694,1403,1291,27,27,862,253,609,1078,972,106,2
2021,Calderdale 026,E02002269,4119,2977,1493,1484,43,43,385,109,276,714,620,94,0
2021,Calderdale 027,E02002270,3580,2838,1480,1358,14,14,175,45,130,552,468,84,1
2021,Kirklees 001,E02002271,3205,2520,1227,1293,7,7,194,77,117,483,410,73,1
2021,Kirklees 002,E02002272,4243,2655,1257,1398,26,26,909,815,94,641,548,93,12
2021,Kirklees 003,E02002273,2880,2092,1057,1035,9,9,275,243,32,497,424,73,7
2021,Kirklees 004,E02002274,2899,2146,1103,1043,8,8,305,255,50,437,387,50,3
2021,Kirklees 005,E02002275,4057,2397,1243,1154,14,14,621,457,164,1010,900,110,15
2021,Kirklees 006,E02002276,3127,2110,1074,1036,9,9,448,337,111,555,470,85,5
2021,Kirklees 007,E02002277,2547,1676,939,737,5,5,290,124,166,572,504,68,4
2021,Kirklees 008,E02002278,2797,1754,837,917,12,12,629,458,171,393,343,50,9
2021,Kirklees 009,E02002279,2822,1512,701,811,3,3,766,550,216,527,484,43,14
2021,Kirklees 010,E02002280,2631,955,629,326,23,23,945,566,379,692,645,47,16
2021,Kirklees 011,E02002281,4433,2878,1358,1520,4,4,689,484,205,841,722,119,21
2021,Kirklees 012,E02002282,2555,1654,822,832,8,8,327,270,57,557,482,75,9
2021,Kirklees 013,E02002283,2339,1468,1046,422,10,10,366,257,109,480,418,62,15
2021,Kirklees 014,E02002284,2700,1953,1030,923,13,13,312,285,27,415,345,70,7
2021,Kirklees 015,E02002285,3372,2636,1415,1221,6,6,233,166,67,494,411,83,3
2021,Kirklees 016,E02002286,2400,1267,629,638,5,5,627,540,87,491,443,48,10
2021,Kirklees 017,E02002287,2757,1260,683,577,6,6,580,379,201,891,817,74,20
2021,Kirklees 018,E02002288,4101,2484,1081,1403,43,43,967,814,153,591,506,85,16
2021,Kirklees 019,E02002289,2146,1175,560,615,5,5,584,445,139,378,324,54,4
2021,Kirklees 020,E02002290,2752,2217,1281,936,8,8,194,173,21,326,280,46,7
2021,Kirklees 021,E02002291,2764,2053,1102,951,5,5,339,307,32,365,311,54,2
2021,Kirklees 022,E02002292,2358,1798,1000,798,8,8,243,184,59,307,268,39,2
2021,Kirklees 023,E02002293,2640,1390,699,691,8,8,587,407,180,630,554,76,25
2021,Kirklees 024,E02002294,3174,2070,1341,729,12,12,543,413,130,540,440,100,9
2021,Kirklees 025,E02002295,3008,1292,527,765,16,16,1209,988,221,472,402,70,19
2021,Kirklees 026,E02002296,3249,2211,1177,1034,9,9,451,334,117,569,511,58,9
2021,Kirklees 027,E02002297,2828,2178,1287,891,8,8,106,74,32,532,466,66,4
2021,Kirklees 028,E02002298,2859,1786,1002,784,6,6,741,720,21,316,267,49,10
2021,Kirklees 029,E02002299,2954,996,508,488,14,14,878,613,265,1046,981,65,20
2021,Kirklees 030,E02002300,3689,2866,1443,1423,23,23,300,161,139,497,441,56,3
2021,Kirklees 031,E02002301,2861,1518,762,756,13,13,307,159,148,1011,925,86,12
2021,Kirklees 032,E02002302,2610,2083,1136,947,4,4,123,90,33,400,342,58,0
2021,Kirklees 033,E02002303,2912,1790,942,848,10,10,309,232,77,797,737,60,6
2021,Kirklees 034,E02002304,3047,1360,774,586,8,8,369,65,304,1310,1216,94,0
2021,Kirklees 035,E02002305,2664,1253,657,596,13,13,814,698,116,568,519,49,16
2021,Kirklees 036,E02002306,2755,2204,1257,947,1,1,159,118,41,388,321,67,3
2021,Kirklees 037,E02002307,2632,1753,955,798,21,21,404,324,80,443,382,61,11
2021,Kirklees 038,E02002308,3061,2073,995,1078,39,39,286,252,34,657,586,71,6
2021,Kirklees 039,E02002309,2761,1345,740,605,6,6,527,339,188,868,767,101,15
2021,Kirklees 040,E02002310,2629,1531,737,794,4,4,512,396,116,582,515,67,0
2021,Kirklees 041,E02002311,2927,1908,919,989,2,2,504,419,85,500,435,65,13
2021,Kirklees 042,E02002312,2940,1136,601,535,6,6,815,535,280,973,897,76,10
2021,Kirklees 043,E02002313,2498,1218,683,535,7,7,303,137,166,955,831,124,15
2021,Kirklees 044,E02002314,2583,1910,1158,752,3,3,300,244,56,369,316,53,1
2021,Kirklees 045,E02002315,3071,1834,851,983,10,10,377,207,170,847,760,87,3
2021,Kirklees 046,E02002316,2918,2295,1271,1024,21,21,289,258,31,309,256,53,4
2021,Kirklees 047,E02002317,2961,1734,941,793,6,6,564,435,129,646,570,76,11
2021,Kirklees 048,E02002318,2878,1636,939,697,19,19,794,590,204,423,374,49,6
2021,Kirklees 049,E02002319,3082,2231,1072,1159,15,15,205,163,42,629,551,78,2
2021,Kirklees 050,E02002320,2939,2072,1280,792,0,0,435,393,42,426,388,38,6
2021,Kirklees 051,E02002321,2673,2132,1220,912,23,23,149,123,26,368,314,54,1
2021,Kirklees 052,E02002322,2808,2114,1198,916,6,6,237,192,45,447,385,62,4
2021,Kirklees 053,E02002323,3640,2842,1635,1207,6,6,313,258,55,475,396,79,4
2021,Kirklees 054,E02002324,2916,2216,1246,970,7,7,290,213,77,396,347,49,7
2021,Kirklees 055,E02002325,3884,2899,1585,1314,31,31,407,298,109,539,469,70,8
2021,Kirklees 056,E02002326,2470,2091,1132,959,15,15,98,70,28,262,206,56,4
2021,Kirklees 057,E02002327,4252,3400,1841,1559,10,10,242,191,51,597,501,96,3
2021,Kirklees 058,E02002328,3068,2454,1439,1015,15,15,189,150,39,406,353,53,4
2021,Kirklees 059,E02002329,5267,4128,2333,1795,23,23,307,227,80,806,695,111,3
2021,Leeds 001,E02002330,3034,2670,1664,1006,15,15,117,86,31,230,197,33,2
2021,Leeds 002,E02002331,3075,1977,1103,874,43,43,619,433,186,431,374,57,5
2021,Leeds 003,E02002332,2880,2063,1178,885,33,33,558,419,139,215,172,43,11
2021,Leeds 004,E02002333,3724,2678,1550,1128,10,10,389,255,134,643,557,86,4
2021,Leeds 005,E02002334,3335,2566,1466,1100,36,36,345,279,66,385,320,65,3
2021,Leeds 006,E02002335,3141,2709,1531,1178,4,4,120,105,15,304,236,68,4
2021,Leeds 007,E02002336,2897,2522,1456,1066,18,18,110,93,17,244,200,44,3
2021,Leeds 008,E02002337,3240,2688,1383,1305,47,47,143,64,79,359,309,50,3
2021,Leeds 009,E02002338,3096,2290,1192,1098,17,17,356,230,126,427,360,67,6
2021,Leeds 010,E02002339,2633,1490,751,739,9,9,734,578,156,393,359,34,7
2021,Leeds 011,E02002340,2745,1920,1042,878,24,24,434,313,121,365,312,53,2
2021,Leeds 012,E02002341,2988,2607,1453,1154,8,8,41,13,28,332,284,48,0
2021,Leeds 013,E02002342,2725,2087,1153,934,24,24,417,327,90,192,165,27,5
2021,Leeds 014,E02002343,2519,2041,945,1096,7,7,154,122,32,317,281,36,0
2021,Leeds 015,E02002344,3457,2632,1454,1178,40,40,173,58,115,612,542,70,0
2021,Leeds 016,E02002345,2523,2114,1119,995,10,10,103,81,22,293,254,39,3
2021,Leeds 017,E02002346,2790,1673,817,856,1,1,790,634,156,315,271,44,11
2021,Leeds 018,E02002347,2756,1320,612,708,9,9,1083,951,132,330,283,47,14
2021,Leeds 019,E02002348,2862,1780,882,898,23,23,681,584,97,366,318,48,12
2021,Leeds 020,E02002349,2597,1792,917,875,5,5,208,78,130,590,555,35,2
2021,Leeds 021,E02002350,2531,2180,1251,929,18,18,49,15,34,284,257,27,0
2021,Leeds 022,E02002351,2352,2083,1174,909,5,5,73,53,20,189,164,25,2
2021,Leeds 023,E02002352,3215,2340,1231,1109,9,9,123,29,94,743,660,83,0
2021,Leeds 024,E02002353,2316,1843,884,959,3,3,174,84,90,291,256,35,5
2021,Leeds 025,E02002354,3322,2218,1019,1199,9,9,648,332,316,442,401,41,5
2021,Leeds 027,E02002356,3820,2980,1305,1675,33,33,319,222,97,486,433,53,2
2021,Leeds 028,E02002357,3745,2287,1024,1263,6,6,752,629,123,692,627,65,8
2021,Leeds 029,E02002358,3640,2415,1063,1352,18,18,843,619,224,357,279,78,7
2021,Leeds 030,E02002359,2876,2288,1286,1002,17,17,258,209,49,308,239,69,5
2021,Leeds 031,E02002360,3066,1831,827,1004,10,10,610,169,441,611,532,79,4
2021,Leeds 032,E02002361,2478,1665,762,903,14,14,423,390,33,368,328,40,8
2021,Leeds 033,E02002362,3599,1627,739,888,6,6,1503,1353,150,453,402,51,10
2021,Leeds 034,E02002363,3399,2155,995,1160,25,25,279,107,172,937,885,52,3
2021,Leeds 035,E02002364,2784,941,442,499,3,3,1568,1475,93,253,200,53,19
2021,Leeds 037,E02002366,2960,2169,1147,1022,6,6,233,39,194,551,487,64,1
2021,Leeds 038,E02002367,2693,980,368,612,11,11,1287,949,338,402,366,36,13
2021,Leeds 039,E02002368,3719,2880,1279,1601,20,20,268,227,41,548,501,47,3
2021,Leeds 040,E02002369,3228,1410,556,854,47,47,1344,1131,213,414,358,56,13
2021,Leeds 041,E02002370,3081,1411,563,848,14,14,1264,981,283,388,334,54,4
2021,Leeds 042,E02002371,4382,1824,947,877,22,22,1353,667,686,1172,1076,96,11
2021,Leeds 044,E02002373,2940,598,303,295,19,19,312,67,245,2011,1970,41,0
2021,Leeds 045,E02002374,3131,1357,616,741,20,20,815,653,162,926,849,77,13
2021,Leeds 046,E02002375,2619,1119,424,695,8,8,1206,1041,165,276,234,42,10
2021,Leeds 047,E02002376,2595,1067,382,685,23,23,1148,987,161,343,298,45,14
2021,Leeds 048,E02002377,2432,838,464,374,12,12,553,179,374,1023,936,87,6
2021,Leeds 050,E02002379,2357,944,381,563,31,31,1146,956,190,229,198,31,7
2021,Leeds 051,E02002380,2524,1670,816,854,11,11,499,453,46,335,288,47,9
2021,Leeds 052,E02002381,3014,1797,751,1046,1,1,597,436,161,610,566,44,9
2021,Leeds 053,E02002382,2403,689,372,317,9,9,402,241,161,1297,1193,104,6
2021,Leeds 054,E02002383,2511,284,158,126,14,14,384,142,242,1828,1800,28,1
2021,Leeds 055,E02002384,4513,663,322,341,11,11,2075,1565,510,1727,1658,69,37
2021,Leeds 056,E02002385,3704,944,414,530,26,26,637,408,229,2088,1992,96,9
2021,Leeds 057,E02002386,4251,3464,1976,1488,6,6,174,84,90,604,532,72,3
2021,Leeds 058,E02002387,2718,1109,474,635,50,50,929,674,255,619,566,53,11
2021,Leeds 059,E02002388,3486,1663,700,963,18,18,1079,805,274,711,642,69,15
2021,Leeds 060,E02002389,2986,962,373,589,47,47,1590,1320,270,370,338,32,17
2021,Leeds 061,E02002390,3075,1865,752,1113,39,39,752,319,433,414,368,46,5
2021,Leeds 062,E02002391,3626,2516,1064,1452,3,3,461,423,38,639,578,61,7
2021,Leeds 063,E02002392,2771,223,114,109,8,8,689,314,375,1848,1763,85,3
2021,Leeds 064,E02002393,4012,414,245,169,29,29,2401,1892,509,1145,1065,80,23
2021,Leeds 065,E02002394,3227,785,390,395,3,3,1336,1121,215,1082,1035,47,21
2021,Leeds 066,E02002395,2771,2059,1020,1039,21,21,106,77,29,583,518,65,2
2021,Leeds 067,E02002396,4086,2211,1081,1130,9,9,662,358,304,1200,1147,53,4
2021,Leeds 068,E02002397,3422,2042,977,1065,20,20,825,737,88,528,472,56,7
2021,Leeds 069,E02002398,3309,2694,1531,1163,7,7,172,112,60,434,359,75,2
2021,Leeds 070,E02002399,2640,1332,672,660,5,5,677,637,40,623,560,63,3
2021,Leeds 071,E02002400,4252,1012,468,544,18,18,1618,1325,293,1583,1502,81,21
2021,Leeds 072,E02002401,2622,893,374,519,19,19,1444,1018,426,251,206,45,15
2021,Leeds 073,E02002402,2497,2129,1201,928,4,4,14,8,6,350,297,53,0
2021,Leeds 074,E02002403,2792,1934,1059,875,10,10,339,267,72,507,447,60,2
2021,Leeds 075,E02002404,5252,1177,449,728,76,76,1431,939,492,2545,2427,118,23
2021,Leeds 076,E02002405,3788,2748,1309,1439,25,25,447,268,179,561,477,84,7
2021,Leeds 077,E02002406,3017,2662,1481,1181,15,15,110,55,55,228,188,40,2
2021,Leeds 078,E02002407,2859,997,435,562,17,17,1277,1216,61,551,495,56,17
2021,Leeds 079,E02002408,3425,2154,991,1163,30,30,627,553,74,605,544,61,9
2021,Leeds 080,E02002409,2695,1630,832,798,13,13,774,707,67,271,241,30,7
2021,Leeds 081,E02002410,3157,1949,933,1016,39,39,627,437,190,540,480,60,2
2021,Leeds 082,E02002411,4308,799,370,429,24,24,1076,767,309,2389,2323,66,20
2021,Leeds 083,E02002412,3250,2255,987,1268,6,6,364,279,85,617,565,52,8
2021,Leeds 085,E02002414,2815,702,328,374,17,17,1130,927,203,952,899,53,14
2021,Leeds 086,E02002415,2714,649,337,312,26,26,614,241,373,1417,1356,61,8
2021,Leeds 087,E02002416,3020,2202,1212,990,16,16,548,500,48,242,206,36,12
2021,Leeds 088,E02002417,3144,2257,1029,1228,60,60,416,323,93,407,371,36,4
2021,Leeds 089,E02002418,3072,2328,1137,1191,4,4,381,291,90,352,301,51,7
2021,Leeds 090,E02002419,3587,1466,743,723,4,4,1408,1248,160,690,647,43,19
2021,Leeds 091,E02002420,3319,1993,1031,962,13,13,261,178,83,1050,957,93,2
2021,Leeds 092,E02002421,2644,793,330,463,7,7,1493,1039,454,332,294,38,19
2021,Leeds 093,E02002422,2816,2230,1104,1126,11,11,154,105,49,419,378,41,2
2021,Leeds 094,E02002423,2459,1308,640,668,5,5,859,752,107,277,236,41,10
2021,Leeds 095,E02002424,3294,2298,1058,1240,6,6,522,418,104,462,397,65,6
2021,Leeds 096,E02002425,3846,2894,1501,1393,27,27,345,292,53,576,485,91,4
2021,Leeds 097,E02002426,3334,2508,1253,1255,21,21,402,315,87,399,348,51,4
2021,Leeds 098,E02002427,3033,1989,1069,920,7,7,712,514,198,320,263,57,5
2021,Leeds 099,E02002428,3417,2142,853,1289,36,36,603,521,82,629,555,74,7
2021,Leeds 100,E02002429,3654,2679,1294,1385,4,4,467,408,59,499,437,62,5
2021,Leeds 101,E02002430,3241,1119,485,634,35,35,1553,1234,319,509,474,35,25
2021,Leeds 102,E02002431,3989,2381,918,1463,28,28,624,544,80,950,873,77,6
2021,Leeds 103,E02002432,3172,2377,1063,1314,29,29,420,372,48,342,285,57,4
2021,Leeds 104,E02002433,3535,1706,810,896,12,12,735,429,306,1078,1009,69,4
2021,Leeds 105,E02002434,4108,2918,952,1966,52,52,492,329,163,642,582,60,4
2021,Leeds 106,E02002435,3639,2741,1290,1451,21,21,210,101,109,665,588,77,2
2021,Leeds 107,E02002436,2987,2021,952,1069,9,9,558,437,121,394,335,59,5
2021,Leeds 108,E02002437,2521,2206,1205,1001,6,6,84,74,10,223,183,40,2
2021,Wakefield 001,E02002438,3663,1765,804,961,18,18,1536,1129,407,341,289,52,3
2021,Wakefield 002,E02002439,4151,2449,1205,1244,13,13,567,372,195,1119,1003,116,3
2021,Wakefield 003,E02002440,3271,2053,1125,928,18,18,954,715,239,239,200,39,7
2021,Wakefield 004,E02002441,4359,2521,1093,1428,29,29,1156,795,361,650,566,84,3
2021,Wakefield 005,E02002442,3147,2398,1193,1205,24,24,170,103,67,555,500,55,0
2021,Wakefield 006,E02002443,2561,2082,1020,1062,17,17,146,91,55,316,273,43,0
2021,Wakefield 007,E02002444,3042,2127,976,1151,31,31,424,298,126,460,404,56,0
2021,Wakefield 008,E02002445,3675,2613,1295,1318,30,30,602,364,238,429,356,73,1
2021,Wakefield 009,E02002446,2649,1998,1107,891,5,5,318,216,102,328,287,41,0
2021,Wakefield 010,E02002447,2730,1648,857,791,12,12,654,491,163,415,367,48,1
2021,Wakefield 011,E02002448,3600,1981,999,982,22,22,1221,936,285,374,323,51,2
2021,Wakefield 012,E02002449,4069,3052,1359,1693,87,87,422,188,234,508,432,76,0
2021,Wakefield 013,E02002450,3335,2268,969,1299,51,51,512,338,174,503,448,55,1
2021,Wakefield 014,E02002451,3464,2665,1451,1214,36,36,464,251,213,297,241,56,2
2021,Wakefield 015,E02002452,4289,2181,903,1278,30,30,1327,866,461,749,682,67,2
2021,Wakefield 016,E02002453,4296,2218,1039,1179,25,25,1341,941,400,708,638,70,4
2021,Wakefield 017,E02002454,4006,1459,704,755,32,32,1031,552,479,1481,1376,105,3
2021,Wakefield 018,E02002455,2709,1368,650,718,17,17,1071,793,278,250,220,30,3
2021,Wakefield 019,E02002456,3204,1663,840,823,8,8,552,334,218,976,912,64,5
2021,Wakefield 020,E02002457,3263,1389,649,740,6,6,1423,955,468,440,395,45,5
2021,Wakefield 021,E02002458,3985,2754,1368,1386,21,21,575,410,165,632,559,73,3
2021,Wakefield 022,E02002459,4144,2463,1046,1417,25,25,1011,708,303,640,571,69,5
2021,Wakefield 023,E02002460,3334,2596,1612,984,40,40,346,203,143,352,286,66,0
2021,Wakefield 024,E02002461,4993,3411,1461,1950,39,39,911,631,280,626,541,85,6
2021,Wakefield 025,E02002462,3460,2195,1219,976,9,9,736,396,340,517,444,73,3
2021,Wakefield 026,E02002463,4070,1558,690,868,56,56,2175,1581,594,274,221,53,7
2021,Wakefield 027,E02002464,4002,2245,1040,1205,61,61,1157,828,329,537,471,66,2
2021,Wakefield 028,E02002465,2904,1917,1186,731,13,13,502,326,176,470,415,55,2
2021,Wakefield 029,E02002466,4112,2695,1461,1234,34,34,896,630,266,487,413,74,0
2021,Wakefield 030,E02002467,3825,1525,726,799,38,38,1053,674,379,1202,1121,81,7
2021,Wakefield 031,E02002468,2743,2014,1123,891,9,9,292,176,116,425,377,48,3
2021,Wakefield 032,E02002469,2746,2060,1124,936,23,23,400,285,115,262,218,44,1
2021,Wakefield 033,E02002470,2670,2343,1484,859,46,46,91,62,29,190,156,34,0
2021,Wakefield 034,E02002471,5004,3918,2133,1785,60,60,443,255,188,581,494,87,2
2021,Wakefield 035,E02002472,2484,1892,1087,805,6,6,306,199,107,279,232,47,1
2021,Wakefield 036,E02002473,2998,2443,1378,1065,35,35,172,55,117,347,293,54,1
2021,Wakefield 037,E02002474,3001,1709,781,928,42,42,952,654,298,295,246,49,3
2021,Wakefield 038,E02002475,2728,2223,1286,937,38,38,205,129,76,261,215,46,1
2021,Wakefield 039,E02002476,2733,1415,634,781,17,17,861,627,234,437,367,70,3
2021,Wakefield 040,E02002477,2734,1735,913,822,3,3,608,360,248,387,318,69,1
2021,Wakefield 041,E02002478,2636,1814,878,936,4,4,360,205,155,458,395,63,0
2021,Wakefield 042,E02002479,3713,2211,1286,925,24,24,922,629,293,552,481,71,4
2021,Wakefield 043,E02002480,2635,1412,864,548,5,5,569,404,165,647,584,63,2
2021,Wakefield 044,E02002481,3053,1808,840,968,17,17,796,511,285,431,371,60,1
2021,Wakefield 045,E02002482,2876,1573,711,862,20,20,947,653,294,333,272,61,3
2021,Hartlepool 001,E02002483,4329,3143,1409,1734,52,52,575,226,349,559,480,79,0
2021,Hartlepool 002,E02002484,4595,1823,914,909,26,26,2017,848,1169,717,624,93,12
2021,Hartlepool 003,E02002485,3540,1562,805,757,66,66,1274,577,697,628,545,83,10
2021,Hartlepool 007,E02002489,3241,1408,749,659,6,6,861,298,563,961,875,86,5
2021,Hartlepool 008,E02002490,2649,1346,773,573,19,19,603,175,428,672,599,73,9
2021,Hartlepool 009,E02002491,2811,1513,873,640,19,19,872,448,424,399,344,55,8
2021,Hartlepool 010,E02002492,2972,1762,893,869,3,3,793,363,430,409,346,63,5
2021,Hartlepool 011,E02002493,2955,2427,1325,1102,8,8,203,34,169,315,255,60,2
2021,Hartlepool 012,E02002494,3389,1330,730,600,5,5,1456,780,676,589,551,38,9
2021,Middlesbrough 001,E02002496,4459,1111,598,513,11,11,1339,320,1019,1988,1842,146,10
2021,Middlesbrough 002,E02002497,2744,912,492,420,8,8,821,479,342,991,902,89,12
2021,Middlesbrough 003,E02002498,3643,889,574,315,12,12,772,347,425,1955,1846,109,15
2021,Middlesbrough 004,E02002499,3064,1314,610,704,15,15,1216,823,393,509,450,59,10
2021,Middlesbrough 005,E02002500,2334,1397,706,691,9,9,178,57,121,746,668,78,4
2021,Middlesbrough 006,E02002501,2608,1250,583,667,20,20,968,514,454,365,319,46,5
2021,Middlesbrough 007,E02002502,4353,1622,875,747,11,11,2048,1302,746,660,589,71,12
2021,Middlesbrough 008,E02002503,2739,1424,625,799,22,22,789,435,354,498,426,72,6
2021,Middlesbrough 009,E02002504,3775,2547,1295,1252,50,50,174,61,113,1000,896,104,4
2021,Middlesbrough 010,E02002505,2644,990,512,478,14,14,1125,729,396,507,465,42,8
2021,Middlesbrough 011,E02002506,2331,813,401,412,9,9,1060,404,656,443,327,116,6
2021,Middlesbrough 012,E02002507,2558,2128,1128,1000,0,0,36,18,18,393,332,61,1
2021,Middlesbrough 013,E02002508,2279,1951,1104,847,1,1,63,20,43,263,217,46,1
2021,Middlesbrough 014,E02002509,2253,1375,827,548,10,10,416,253,163,449,400,49,3
2021,Middlesbrough 015,E02002510,3116,2663,1424,1239,19,19,86,20,66,346,282,64,2
2021,Middlesbrough 017,E02002512,2306,1983,1115,868,25,25,97,20,77,201,172,29,0
2021,Middlesbrough 018,E02002513,4530,2561,1153,1408,14,14,1490,557,933,461,378,83,4
2021,Middlesbrough 019,E02002514,3788,2218,1092,1126,45,45,1158,380,778,360,312,48,7
2021,Redcar and Cleveland 001,E02002515,3129,1563,857,706,8,8,291,82,209,1265,1134,131,2
2021,Redcar and Cleveland 002,E02002516,2564,1631,785,846,36,36,546,232,314,348,288,60,3
2021,Redcar and Cleveland 003,E02002517,2386,1350,723,627,10,10,674,311,363,351,284,67,1
2021,Redcar and Cleveland 004,E02002518,4767,3950,2120,1830,44,44,220,87,133,552,447,105,1
2021,Redcar and Cleveland 005,E02002519,3394,1678,902,776,11,11,1363,591,772,334,285,49,8
2021,Redcar and Cleveland 006,E02002520,5954,4642,2742,1900,50,50,511,172,339,749,622,127,2
2021,Redcar and Cleveland 007,E02002521,2867,1920,1254,666,4,4,336,79,257,606,534,72,1
2021,Redcar and Cleveland 009,E02002523,2673,739,378,361,8,8,1521,843,678,398,373,25,7
2021,Redcar and Cleveland 010,E02002524,2380,1665,984,681,6,6,346,122,224,363,325,38,0
2021,Redcar and Cleveland 011,E02002525,3794,2302,1300,1002,13,13,860,411,449,615,517,98,4
2021,Redcar and Cleveland 012,E02002526,3385,2243,1194,1049,12,12,537,256,281,593,538,55,0
2021,Redcar and Cleveland 013,E02002527,2222,1192,728,464,21,21,477,203,274,530,471,59,2
2021,Redcar and Cleveland 015,E02002529,2616,1671,964,707,3,3,568,302,266,373,322,51,1
2021,Redcar and Cleveland 016,E02002530,2887,1799,1094,705,7,7,620,252,368,459,391,68,2
2021,Redcar and Cleveland 018,E02002532,3231,1717,914,803,33,33,791,340,451,687,609,78,3
2021,Redcar and Cleveland 019,E02002533,2847,2327,1368,959,26,26,188,78,110,305,268,37,1
2021,Redcar and Cleveland 020,E02002534,2502,2203,1462,741,8,8,56,24,32,235,190,45,0
2021,Stockton-on-Tees 001,E02002535,4041,3406,1817,1589,20,20,180,92,88,434,374,60,1
2021,Stockton-on-Tees 002,E02002536,4257,2648,1429,1219,13,13,742,419,323,849,738,111,5
2021,Stockton-on-Tees 003,E02002537,3607,1878,950,928,7,7,1020,723,297,697,623,74,5
2021,Stockton-on-Tees 004,E02002538,2451,1439,714,725,6,6,565,329,236,437,402,35,4
2021,Stockton-on-Tees 005,E02002539,4301,3745,1943,1802,7,7,210,86,124,338,263,75,1
2021,Stockton-on-Tees 006,E02002540,2826,2350,1417,933,19,19,159,27,132,298,232,66,0
2021,Stockton-on-Tees 007,E02002541,2875,1959,1077,882,4,4,304,155,149,605,532,73,3
2021,Stockton-on-Tees 008,E02002542,3368,1711,810,901,3,3,1083,740,343,567,504,63,4
2021,Stockton-on-Tees 009,E02002543,3859,1726,637,1089,24,24,1445,847,598,661,608,53,3
2021,Stockton-on-Tees 010,E02002544,3569,1721,841,880,24,24,988,444,544,832,750,82,4
2021,Stockton-on-Tees 011,E02002545,2267,1921,1119,802,2,2,117,54,63,227,183,44,0
2021,Stockton-on-Tees 012,E02002546,3059,1543,725,818,7,7,811,436,375,691,615,76,7
2021,Stockton-on-Tees 013,E02002547,2764,2231,1352,879,14,14,292,152,140,227,177,50,0
2021,Stockton-on-Tees 015,E02002549,3309,2764,1670,1094,10,10,164,75,89,369,290,79,2
2021,Stockton-on-Tees 016,E02002550,2582,1839,1010,829,2,2,298,82,216,442,390,52,1
2021,Stockton-on-Tees 017,E02002551,2630,881,434,447,2,2,791,263,528,950,889,61,6
2021,Stockton-on-Tees 018,E02002552,3002,1718,747,971,26,26,690,313,377,561,419,142,7
2021,Stockton-on-Tees 019,E02002553,2487,1588,802,786,5,5,415,246,169,476,417,59,3
2021,Stockton-on-Tees 020,E02002554,2294,1152,679,473,14,14,790,470,320,334,287,47,4
2021,Stockton-on-Tees 021,E02002555,4385,3441,1889,1552,22,22,267,139,128,654,553,101,1
2021,Stockton-on-Tees 022,E02002556,2880,2479,1283,1196,21,21,35,17,18,344,302,42,1
2021,Stockton-on-Tees 024,E02002558,4890,3762,2040,1722,59,59,365,122,243,704,610,94,0
2021,Darlington 001,E02002559,4121,3217,1567,1650,17,17,198,126,72,687,586,101,2
2021,Darlington 002,E02002560,2689,2051,1082,969,22,22,187,77,110,429,361,68,0
2021,Darlington 003,E02002561,2476,1870,1138,732,6,6,273,112,161,325,281,44,2
2021,Darlington 004,E02002562,2854,1297,652,645,3,3,651,464,187,899,824,75,4
2021,Darlington 005,E02002563,2472,1522,802,720,8,8,643,510,133,298,259,39,1
2021,Darlington 006,E02002564,4352,2580,1245,1335,35,35,1181,829,352,556,472,84,0
2021,Darlington 009,E02002567,4111,2150,1007,1143,36,36,1195,740,455,727,652,75,3
2021,Darlington 010,E02002568,2722,2048,1184,864,7,7,201,80,121,466,418,48,0
2021,Darlington 011,E02002569,4064,3554,2261,1293,8,8,206,61,145,295,230,65,1
2021,Darlington 012,E02002570,3601,1671,865,806,6,6,857,617,240,1066,982,84,1
2021,Darlington 013,E02002571,2699,1527,718,809,5,5,624,538,86,543,481,62,0
2021,Darlington 014,E02002572,2796,1428,682,746,8,8,701,553,148,656,598,58,3
2021,Darlington 015,E02002573,3972,3150,1631,1519,16,16,296,154,142,508,441,67,2
2021,Halton 001,E02002574,3588,3128,1506,1622,5,5,121,31,90,334,283,51,0
2021,Halton 002,E02002575,3812,3286,1550,1736,9,9,135,23,112,381,343,38,1
2021,Halton 003,E02002576,3399,2090,1067,1023,55,55,688,165,523,563,493,70,3
2021,Halton 004,E02002577,3238,1465,781,684,5,5,1425,371,1054,336,290,46,7
2021,Halton 005,E02002578,3499,2348,1114,1234,8,8,686,223,463,453,373,80,4
2021,Halton 006,E02002579,3377,1820,931,889,32,32,1068,330,738,452,406,46,5
2021,Halton 007,E02002580,3686,1278,634,644,29,29,1277,391,886,1096,1024,72,6
2021,Halton 008,E02002581,3088,2320,1306,1014,11,11,380,153,227,377,315,62,0
2021,Halton 009,E02002582,3624,3232,1409,1823,74,74,104,9,95,214,164,50,0
2021,Halton 010,E02002583,3386,1109,560,549,69,69,1953,250,1703,254,221,33,1
2021,Halton 011,E02002584,3110,2084,1074,1010,13,13,621,146,475,389,328,61,3
2021,Halton 012,E02002585,5209,2735,1315,1420,22,22,909,173,736,1539,1433,106,4
2021,Halton 013,E02002586,4072,1678,831,847,22,22,1806,348,1458,562,491,71,4
2021,Halton 014,E02002587,2874,1454,791,663,51,51,991,128,863,372,335,37,6
2021,Halton 015,E02002588,3261,1349,736,613,3,3,1415,150,1265,491,429,62,3
2021,Halton 016,E02002589,2725,2460,1488,972,19,19,44,8,36,202,158,44,0
2021,Warrington 001,E02002590,2639,2254,1285,969,5,5,146,52,94,233,193,40,1
2021,Warrington 002,E02002591,2854,2228,1282,946,11,11,316,163,153,298,244,54,1
2021,Warrington 003,E02002592,2576,2116,1191,925,14,14,193,110,83,253,196,57,0
2021,Warrington 004,E02002593,2362,1515,880,635,33,33,487,72,415,326,287,39,1
2021,Warrington 005,E02002594,2601,1332,702,630,24,24,865,146,719,377,346,31,3
2021,Warrington 006,E02002595,3448,1572,679,893,12,12,1439,846,593,418,367,51,7
2021,Warrington 007,E02002596,3511,2737,1561,1176,24,24,401,43,358,347,291,56,2
2021,Warrington 008,E02002597,3859,1681,823,858,8,8,1787,694,1093,382,333,49,1
2021,Warrington 009,E02002598,4263,3433,1130,2303,110,110,221,23,198,498,446,52,1
2021,Warrington 010,E02002599,4377,3319,1610,1709,79,79,448,52,396,531,464,67,0
2021,Warrington 011,E02002600,4163,2419,1185,1234,27,27,849,320,529,865,753,112,3
2021,Warrington 012,E02002601,3847,3200,1618,1582,16,16,292,81,211,339,277,62,0
2021,Warrington 013,E02002602,3529,1416,604,812,17,17,1153,523,630,938,883,55,5
2021,Warrington 014,E02002603,2870,2502,1454,1048,1,1,122,60,62,245,194,51,0
2021,Warrington 015,E02002604,3239,2840,1525,1315,20,20,140,40,100,238,197,41,1
2021,Warrington 016,E02002605,3729,2755,1305,1450,32,32,465,65,400,472,414,58,5
2021,Warrington 017,E02002606,5483,2217,1007,1210,37,37,1072,316,756,2149,1982,167,8
2021,Warrington 018,E02002607,5650,2699,1407,1292,26,26,1085,387,698,1834,1710,124,6
2021,Warrington 019,E02002608,3561,3122,1836,1286,5,5,146,65,81,288,221,67,0
2021,Warrington 020,E02002609,4393,2101,815,1286,76,76,1165,525,640,1047,958,89,4
2021,Warrington 021,E02002610,5311,4203,2263,1940,43,43,405,187,218,658,573,85,2
2021,Warrington 022,E02002611,3255,2854,1549,1305,14,14,165,27,138,222,178,44,0
2021,Warrington 023,E02002612,3988,3055,1576,1479,29,29,386,145,241,517,444,73,1
2021,Warrington 024,E02002613,2639,2346,1226,1120,12,12,70,29,41,211,170,41,0
2021,Warrington 025,E02002614,2379,2269,1426,843,0,0,24,11,13,86,72,14,0
2021,Blackburn with Darwen 001,E02002615,4119,2993,1627,1366,7,7,497,157,340,617,528,89,5
2021,Blackburn with Darwen 002,E02002616,2994,2466,1375,1091,5,5,51,10,41,468,375,93,4
2021,Blackburn with Darwen 003,E02002617,2766,1573,1018,555,15,15,592,94,498,584,473,111,2
2021,Blackburn with Darwen 004,E02002618,2205,1460,998,462,12,12,348,85,263,383,304,79,2
2021,Blackburn with Darwen 005,E02002619,3040,1646,947,699,26,26,483,107,376,879,750,129,6
2021,Blackburn with Darwen 006,E02002620,3418,1114,771,343,15,15,1508,272,1236,779,670,109,2
2021,Blackburn with Darwen 007,E02002621,2540,1301,980,321,19,19,765,181,584,446,357,89,9
2021,Blackburn with Darwen 008,E02002622,3981,1499,813,686,9,9,1683,515,1168,787,689,98,3
2021,Blackburn with Darwen 009,E02002623,4702,1907,949,958,39,39,1080,241,839,1675,1532,143,1
2021,Blackburn with Darwen 010,E02002624,3591,3115,1775,1340,3,3,133,23,110,339,275,64,1
2021,Blackburn with Darwen 011,E02002625,3957,2038,955,1083,24,24,1252,338,914,643,566,77,0
2021,Blackburn with Darwen 012,E02002626,3146,1903,1091,812,29,29,766,249,517,446,383,63,2
2021,Blackburn with Darwen 013,E02002627,2934,2460,1000,1460,7,7,39,7,32,428,370,58,0
2021,Blackburn with Darwen 014,E02002628,3118,1857,969,888,15,15,469,131,338,775,705,70,2
2021,Blackburn with Darwen 015,E02002629,2641,1407,758,649,5,5,461,136,325,768,690,78,0
2021,Blackburn with Darwen 016,E02002630,2899,1506,746,760,45,45,506,109,397,839,768,71,3
2021,Blackburn with Darwen 017,E02002631,4020,2965,1504,1461,29,29,344,60,284,680,601,79,2
2021,Blackburn with Darwen 018,E02002632,2703,2324,1299,1025,9,9,56,4,52,313,256,57,1
2021,Blackpool 001,E02002633,3575,2742,1673,1069,5,5,56,26,30,771,679,92,1
2021,Blackpool 002,E02002634,4046,2532,1489,1043,23,23,793,539,254,688,606,82,10
2021,Blackpool 003,E02002635,3651,2660,1599,1061,5,5,68,29,39,917,806,111,1
2021,Blackpool 004,E02002636,3708,2387,1210,1177,26,26,456,277,179,836,747,89,3
2021,Blackpool 005,E02002637,2706,2044,1066,978,6,6,57,41,16,598,530,68,1
2021,Blackpool 006,E02002638,2938,1018,573,445,6,6,245,51,194,1669,1570,99,0
2021,Blackpool 007,E02002639,2718,893,486,407,16,16,1326,987,339,465,429,36,18
2021,Blackpool 008,E02002640,3329,1090,548,542,15,15,818,436,382,1395,1321,74,11
2021,Blackpool 009,E02002641,3597,2334,1181,1153,5,5,82,36,46,1176,1058,118,0
2021,Blackpool 010,E02002642,3394,1020,610,410,12,12,328,134,194,2031,1943,88,3
2021,Blackpool 011,E02002643,3389,1614,831,783,9,9,219,121,98,1545,1439,106,2
2021,Blackpool 012,E02002644,3497,2488,1284,1204,4,4,51,27,24,954,849,105,0
2021,Blackpool 013,E02002645,2838,876,506,370,41,41,257,64,193,1662,1585,77,2
2021,Blackpool 014,E02002646,3383,1979,1049,930,4,4,735,545,190,659,585,74,6
2021,Blackpool 015,E02002647,3628,1941,992,949,9,9,229,107,122,1447,1335,112,2
2021,Blackpool 016,E02002648,3219,1895,971,924,7,7,335,205,130,979,887,92,3
2021,Blackpool 017,E02002649,3734,2306,1212,1094,5,5,140,45,95,1283,1180,103,0
2021,Blackpool 018,E02002650,3902,2865,1610,1255,12,12,228,96,132,796,693,103,1
2021,Blackpool 019,E02002651,3532,2546,1458,1088,7,7,279,181,98,697,600,97,3
2021,Kingston upon Hull 002,E02002653,3381,1131,587,544,0,0,1854,1650,204,378,336,42,18
2021,Kingston upon Hull 003,E02002654,3070,737,398,339,10,10,2007,1706,301,302,269,33,14
2021,Kingston upon Hull 004,E02002655,3524,1438,605,833,6,6,1597,1510,87,467,419,48,16
2021,Kingston upon Hull 005,E02002656,2559,2033,1249,784,9,9,42,13,29,474,400,74,1
2021,Kingston upon Hull 006,E02002657,3246,2476,1334,1142,4,4,316,252,64,443,394,49,7
2021,Kingston upon Hull 007,E02002658,3023,2075,1093,982,14,14,451,239,212,478,418,60,5
2021,Kingston upon Hull 008,E02002659,4607,1420,683,737,7,7,2501,1871,630,660,585,75,19
2021,Kingston upon Hull 009,E02002660,3072,1542,862,680,5,5,1114,1056,58,399,358,41,12
2021,Kingston upon Hull 010,E02002661,3380,1837,871,966,6,6,1134,1056,78,393,326,67,10
2021,Kingston upon Hull 011,E02002662,3365,1719,787,932,74,74,1234,747,487,320,269,51,18
2021,Kingston upon Hull 012,E02002663,2413,1292,643,649,11,11,176,39,137,934,883,51,0
2021,Kingston upon Hull 013,E02002664,2956,2559,1398,1161,4,4,69,57,12,322,278,44,2
2021,Kingston upon Hull 014,E02002665,3363,2397,1267,1130,15,15,344,184,160,603,550,53,4
2021,Kingston upon Hull 015,E02002666,3529,837,468,369,36,36,584,208,376,2064,1986,78,8
2021,Kingston upon Hull 016,E02002667,3374,2166,1041,1125,7,7,225,138,87,974,904,70,2
2021,Kingston upon Hull 017,E02002668,3593,851,401,450,36,36,2408,1497,911,282,248,34,16
2021,Kingston upon Hull 018,E02002669,3602,1602,784,818,16,16,219,49,170,1764,1676,88,1
2021,Kingston upon Hull 019,E02002670,3607,1909,918,991,12,12,1118,849,269,552,494,58,16
2021,Kingston upon Hull 020,E02002671,3436,2013,919,1094,38,38,715,502,213,667,604,63,3
2021,Kingston upon Hull 021,E02002672,2858,994,468,526,23,23,1367,1078,289,464,433,31,10
2021,Kingston upon Hull 022,E02002673,3381,1883,937,946,11,11,367,145,222,1116,1031,85,4
2021,Kingston upon Hull 023,E02002674,3220,2070,1001,1069,3,3,200,172,28,944,874,70,3
2021,Kingston upon Hull 024,E02002675,3859,866,431,435,16,16,1639,1190,449,1312,1239,73,26
2021,Kingston upon Hull 025,E02002676,3471,1817,903,914,10,10,287,220,67,1346,1223,123,11
2021,Kingston upon Hull 026,E02002677,4131,1661,807,854,5,5,905,500,405,1513,1401,112,47
2021,Kingston upon Hull 027,E02002678,3706,2126,947,1179,24,24,237,81,156,1314,1193,121,5
2021,Kingston upon Hull 028,E02002679,3405,2253,1119,1134,4,4,647,477,170,488,438,50,13
2021,Kingston upon Hull 029,E02002680,5414,800,397,403,30,30,2435,1645,790,2119,2010,109,30
2021,Kingston upon Hull 030,E02002681,3999,1033,636,397,22,22,1022,609,413,1895,1795,100,27
2021,Kingston upon Hull 031,E02002682,4588,1935,716,1219,13,13,1585,861,724,1033,965,68,22
2021,East Riding of Yorkshire 001,E02002684,4962,3825,2772,1053,14,14,356,254,102,766,662,104,1
2021,East Riding of Yorkshire 002,E02002685,3759,2931,2105,826,5,5,207,136,71,613,525,88,3
2021,East Riding of Yorkshire 003,E02002686,3632,1452,897,555,15,15,1421,1240,181,707,628,79,37
2021,East Riding of Yorkshire 004,E02002687,2828,1488,983,505,29,29,193,78,115,1117,1017,100,1
2021,East Riding of Yorkshire 005,E02002688,2586,1195,806,389,1,1,160,50,110,1230,1150,80,0
2021,East Riding of Yorkshire 006,E02002689,2544,1889,1245,644,4,4,188,151,37,460,370,90,3
2021,East Riding of Yorkshire 008,E02002691,3670,2822,1730,1092,28,28,226,183,43,593,466,127,1
2021,East Riding of Yorkshire 009,E02002692,3842,3201,1786,1415,29,29,235,137,98,377,299,78,0
2021,East Riding of Yorkshire 010,E02002693,3137,2426,1498,928,2,2,213,149,64,495,385,110,1
2021,East Riding of Yorkshire 011,E02002694,5850,4076,2271,1805,36,36,645,417,228,1090,915,175,3
2021,East Riding of Yorkshire 012,E02002695,3710,2651,1826,825,10,10,386,252,134,658,553,105,5
2021,East Riding of Yorkshire 013,E02002696,2472,1939,1153,786,0,0,72,54,18,460,325,135,1
2021,East Riding of Yorkshire 014,E02002697,3304,2712,1656,1056,5,5,186,131,55,398,315,83,3
2021,East Riding of Yorkshire 015,E02002698,3765,2710,1463,1247,37,37,386,263,123,627,544,83,5
2021,East Riding of Yorkshire 016,E02002699,4326,3698,2216,1482,26,26,137,60,77,465,386,79,0
2021,East Riding of Yorkshire 017,E02002700,2787,1312,655,657,20,20,1027,926,101,401,345,56,27
2021,East Riding of Yorkshire 018,E02002701,3666,3029,1763,1266,26,26,205,113,92,402,274,128,4
2021,East Riding of Yorkshire 019,E02002702,5102,3111,1908,1203,28,28,624,331,293,1326,1201,125,13
2021,East Riding of Yorkshire 020,E02002703,3913,3243,1885,1358,26,26,246,121,125,396,341,55,2
2021,East Riding of Yorkshire 021,E02002704,3177,2605,1649,956,3,3,179,152,27,386,303,83,4
2021,East Riding of Yorkshire 022,E02002705,3137,2597,1584,1013,20,20,268,202,66,250,194,56,2
2021,East Riding of Yorkshire 023,E02002706,3240,2627,1468,1159,7,7,198,172,26,403,358,45,5
2021,East Riding of Yorkshire 024,E02002707,2918,2463,1492,971,19,19,122,100,22,313,260,53,1
2021,East Riding of Yorkshire 025,E02002708,2891,2006,1341,665,9,9,454,398,56,417,361,56,5
2021,East Riding of Yorkshire 026,E02002709,3291,2545,1466,1079,9,9,278,209,69,454,376,78,5
2021,East Riding of Yorkshire 027,E02002710,3174,2550,1408,1142,3,3,206,186,20,410,356,54,5
2021,East Riding of Yorkshire 028,E02002711,3406,3085,1833,1252,19,19,60,26,34,241,183,58,1
2021,East Riding of Yorkshire 029,E02002712,3358,2550,1524,1026,3,3,194,163,31,605,524,81,6
2021,East Riding of Yorkshire 031,E02002714,3436,2701,1651,1050,3,3,209,189,20,519,433,86,4
2021,East Riding of Yorkshire 032,E02002715,5634,4454,2039,2415,22,22,260,220,40,893,798,95,5
2021,East Riding of Yorkshire 033,E02002716,3700,2876,1583,1293,30,30,340,242,98,451,374,77,3
2021,East Riding of Yorkshire 034,E02002717,3737,2343,1137,1206,11,11,567,468,99,807,714,93,9
2021,East Riding of Yorkshire 035,E02002718,3403,2911,1719,1192,9,9,145,78,67,337,290,47,1
2021,East Riding of Yorkshire 036,E02002719,2794,2212,1090,1122,13,13,229,129,100,336,286,50,4
2021,East Riding of Yorkshire 037,E02002720,3252,2719,1531,1188,5,5,66,56,10,461,400,61,1
2021,East Riding of Yorkshire 038,E02002721,2959,2104,1175,929,19,19,436,355,81,388,327,61,12
2021,East Riding of Yorkshire 039,E02002722,3789,2342,1577,765,11,11,603,526,77,825,711,114,8
2021,East Riding of Yorkshire 040,E02002723,3730,2149,1277,872,7,7,326,232,94,1243,1162,81,5
2021,East Riding of Yorkshire 041,E02002724,4111,1933,937,996,6,6,964,894,70,1191,1119,72,17
2021,East Riding of Yorkshire 042,E02002725,2923,2301,1240,1061,12,12,273,229,44,332,273,59,5
2021,North East Lincolnshire 001,E02002726,4454,2942,1585,1357,10,10,759,246,513,741,659,82,2
2021,North East Lincolnshire 002,E02002727,2594,461,258,203,14,14,1296,398,898,814,759,55,9
2021,North East Lincolnshire 003,E02002728,3652,1435,762,673,12,12,530,130,400,1674,1577,97,1
2021,North East Lincolnshire 004,E02002729,2563,1660,886,774,9,9,549,213,336,339,298,41,6
2021,North East Lincolnshire 005,E02002730,3080,1356,717,639,7,7,189,41,148,1528,1420,108,0
2021,North East Lincolnshire 006,E02002731,2375,982,494,488,2,2,291,80,211,1098,1054,44,2
2021,North East Lincolnshire 007,E02002732,3323,2753,1430,1323,15,15,188,40,148,366,297,69,1
2021,North East Lincolnshire 008,E02002733,2766,1621,889,732,6,6,296,37,259,843,772,71,0
2021,North East Lincolnshire 009,E02002734,2441,1602,830,772,70,70,300,96,204,464,409,55,5
2021,North East Lincolnshire 011,E02002736,2415,1011,488,523,10,10,213,41,172,1178,1125,53,3
2021,North East Lincolnshire 012,E02002737,3039,2293,1202,1091,12,12,196,65,131,535,460,75,3
2021,North East Lincolnshire 013,E02002738,2971,2236,1181,1055,3,3,279,122,157,452,390,62,1
2021,North East Lincolnshire 014,E02002739,2836,1667,882,785,4,4,395,89,306,768,699,69,2
2021,North East Lincolnshire 015,E02002740,2364,1373,744,629,12,12,594,214,380,383,340,43,2
2021,North East Lincolnshire 016,E02002741,3675,2627,1367,1260,20,20,149,43,106,879,815,64,0
2021,North East Lincolnshire 018,E02002743,2644,1663,1075,588,18,18,655,181,474,305,257,48,3
2021,North East Lincolnshire 019,E02002744,2776,1023,545,478,7,7,1313,492,821,428,392,36,5
2021,North East Lincolnshire 020,E02002745,3341,2915,1897,1018,17,17,90,12,78,319,250,69,0
2021,North East Lincolnshire 021,E02002746,4280,3370,1657,1713,36,36,331,82,249,542,473,69,1
2021,North East Lincolnshire 022,E02002747,4026,3463,1894,1569,50,50,180,37,143,332,271,61,1
2021,North East Lincolnshire 023,E02002748,3534,2879,1761,1118,11,11,242,40,202,402,323,79,0
2021,North Lincolnshire 001,E02002749,5365,3716,2042,1674,20,20,680,263,417,947,832,115,2
2021,North Lincolnshire 002,E02002750,2734,2095,1162,933,9,9,194,70,124,434,365,69,2
2021,North Lincolnshire 003,E02002751,2751,2013,1219,794,11,11,338,143,195,389,313,76,0
2021,North Lincolnshire 004,E02002752,3049,2147,1239,908,7,7,363,138,225,530,447,83,2
2021,North Lincolnshire 005,E02002753,4017,2974,1860,1114,15,15,343,130,213,681,584,97,4
2021,North Lincolnshire 006,E02002754,3567,2568,1407,1161,6,6,468,205,263,522,447,75,3
2021,North Lincolnshire 007,E02002755,3006,1481,732,749,9,9,653,308,345,858,789,69,5
2021,North Lincolnshire 008,E02002756,3367,1067,544,523,18,18,1008,565,443,1266,1175,91,8
2021,North Lincolnshire 009,E02002757,2523,1851,1014,837,0,0,140,64,76,532,460,72,0
2021,North Lincolnshire 010,E02002758,2779,1544,809,735,3,3,637,280,357,592,536,56,3
2021,North Lincolnshire 011,E02002759,4272,2938,1795,1143,9,9,585,213,372,734,631,103,6
2021,North Lincolnshire 012,E02002760,2498,1700,966,734,6,6,535,246,289,253,208,45,4
2021,North Lincolnshire 013,E02002761,2866,2169,1238,931,5,5,211,66,145,479,404,75,2
2021,North Lincolnshire 014,E02002762,2830,1583,807,776,12,12,770,362,408,462,408,54,3
2021,North Lincolnshire 015,E02002763,3750,1972,764,1208,5,5,1077,549,528,686,623,63,10
2021,North Lincolnshire 016,E02002764,2321,1065,579,486,4,4,938,551,387,313,287,26,1
2021,North Lincolnshire 017,E02002765,2725,1681,917,764,4,4,544,277,267,491,427,64,5
2021,North Lincolnshire 018,E02002766,3813,2869,1573,1296,13,13,364,184,180,566,490,76,1
2021,North Lincolnshire 019,E02002767,3061,2603,1507,1096,13,13,72,10,62,372,323,49,1
2021,North Lincolnshire 020,E02002768,3256,2521,1501,1020,13,13,308,122,186,410,328,82,4
2021,North Lincolnshire 021,E02002769,2524,2060,1313,747,3,3,177,65,112,284,228,56,0
2021,North Lincolnshire 022,E02002770,3064,2281,1326,955,13,13,303,120,183,467,399,68,0
2021,North Lincolnshire 023,E02002771,3032,2498,1515,983,6,6,243,103,140,285,226,59,0
2021,York 001,E02002772,2785,2223,1210,1013,10,10,177,30,147,375,246,129,0
2021,York 002,E02002773,2619,2180,1438,742,6,6,220,40,180,213,179,34,0
2021,York 003,E02002774,2635,2357,1485,872,9,9,49,20,29,220,185,35,0
2021,York 004,E02002775,2599,1520,1004,516,105,105,797,50,747,177,130,47,0
2021,York 005,E02002776,3027,2277,1342,935,40,40,328,42,286,382,321,61,0
2021,York 006,E02002777,3833,2909,1338,1571,19,19,386,56,330,518,464,54,1
2021,York 007,E02002778,3540,2737,1607,1130,13,13,185,63,122,605,537,68,0
2021,York 008,E02002779,4152,3188,2033,1155,11,11,397,284,113,552,465,87,4
2021,York 009,E02002780,3446,1543,728,815,21,21,941,741,200,931,863,68,10
2021,York 010,E02002781,4141,1819,900,919,66,66,871,633,238,1375,1286,89,10
2021,York 011,E02002782,2539,2141,1318,823,22,22,144,94,50,231,181,50,1
2021,York 012,E02002783,4288,3193,1632,1561,30,30,567,393,174,494,434,60,4
2021,York 013,E02002784,5688,1715,1027,688,51,51,1354,930,424,2555,2370,185,13
2021,York 014,E02002785,3239,2398,1360,1038,76,76,258,63,195,507,440,67,0
2021,York 015,E02002786,3862,1531,773,758,21,21,891,775,116,1407,1322,85,12
2021,York 016,E02002787,4300,2656,1402,1254,30,30,799,619,180,809,742,67,6
2021,York 017,E02002788,3918,2379,1191,1188,23,23,248,110,138,1264,1188,76,4
2021,York 018,E02002789,3976,2072,886,1186,21,21,1460,1180,280,408,350,58,15
2021,York 019,E02002790,4632,2242,1290,952,58,58,517,277,240,1811,1570,241,4
2021,York 020,E02002791,2707,2287,1434,853,16,16,152,90,62,249,191,58,3
2021,York 021,E02002792,3515,2494,1369,1125,10,10,205,37,168,805,748,57,1
2021,York 022,E02002793,4223,3115,1779,1336,33,33,613,392,221,456,385,71,6
2021,York 023,E02002794,2213,1563,921,642,14,14,219,127,92,415,344,71,2
2021,York 024,E02002795,3580,3093,1985,1108,13,13,142,102,40,328,268,60,4
2021,Derby 001,E02002796,2600,2247,1349,898,32,32,95,70,25,224,188,36,2
2021,Derby 002,E02002797,3325,2938,1954,984,8,8,58,32,26,320,267,53,1
2021,Derby 003,E02002798,4471,3542,1829,1713,18,18,150,51,99,761,704,57,0
2021,Derby 004,E02002799,2568,1515,644,871,26,26,617,469,148,405,364,41,5
2021,Derby 005,E02002800,3169,2121,1140,981,19,19,390,122,268,637,589,48,2
2021,Derby 006,E02002801,3173,2330,1238,1092,10,10,455,378,77,375,308,67,3
2021,Derby 007,E02002802,3275,1459,757,702,6,6,1305,1141,164,484,429,55,21
2021,Derby 008,E02002803,3612,1026,494,532,104,104,1202,599,603,1277,1202,75,3
2021,Derby 009,E02002804,3760,2291,1058,1233,30,30,1004,779,225,426,354,72,9
2021,Derby 010,E02002805,2606,2187,1387,800,13,13,122,54,68,284,229,55,0
2021,Derby 011,E02002806,2821,849,440,409,20,20,655,324,331,1291,1227,64,6
2021,Derby 012,E02002807,3739,2607,1404,1203,7,7,656,566,90,460,394,66,9
2021,Derby 013,E02002808,5855,1238,587,651,55,55,1517,525,992,3036,2900,136,9
2021,Derby 014,E02002809,3015,1986,1047,939,36,36,594,379,215,396,358,38,3
2021,Derby 015,E02002810,3916,3215,1865,1350,38,38,223,66,157,440,400,40,0
2021,Derby 016,E02002811,3632,1404,730,674,7,7,671,275,396,1542,1426,116,8
2021,Derby 017,E02002812,3012,1935,1052,883,24,24,427,246,181,618,544,74,8
2021,Derby 018,E02002813,3951,1333,759,574,36,36,1151,495,656,1418,1258,160,13
2021,Derby 019,E02002814,3225,2592,1639,953,11,11,228,114,114,392,338,54,2
2021,Derby 020,E02002815,2506,1269,687,582,14,14,276,81,195,942,837,105,5
2021,Derby 021,E02002816,3380,2498,1282,1216,47,47,317,35,282,518,480,38,0
2021,Derby 022,E02002817,2370,1919,1157,762,7,7,117,100,17,325,282,43,2
2021,Derby 023,E02002818,2902,1309,625,684,12,12,880,614,266,690,620,70,11
2021,Derby 024,E02002819,3546,1888,955,933,48,48,619,316,303,983,921,62,8
2021,Derby 025,E02002820,4136,2314,1096,1218,6,6,819,613,206,988,896,92,9
2021,Derby 026,E02002821,4538,1696,686,1010,11,11,1817,1340,477,996,922,74,18
2021,Derby 027,E02002822,2727,1802,996,806,32,32,446,274,172,444,399,45,3
2021,Derby 028,E02002823,3276,2122,1204,918,8,8,796,412,384,343,285,58,7
2021,Derby 029,E02002824,3984,2115,1043,1072,19,19,1240,822,418,597,524,73,13
2021,Derby 030,E02002825,3652,2556,1291,1265,39,39,518,269,249,536,481,55,3
2021,Derby 031,E02002826,2908,2073,995,1078,47,47,482,152,330,301,268,33,5
2021,Leicester 001,E02002827,2642,1487,702,785,24,24,728,577,151,392,353,39,11
2021,Leicester 002,E02002828,3046,2213,1242,971,21,21,145,40,105,667,602,65,0
2021,Leicester 003,E02002829,4349,1695,785,910,19,19,1825,1421,404,788,724,64,22
2021,Leicester 004,E02002830,3935,1637,719,918,28,28,1547,914,633,714,615,99,9
2021,Leicester 005,E02002831,2385,1571,909,662,2,2,174,125,49,632,558,74,6
2021,Leicester 006,E02002832,3314,1523,942,581,14,14,797,226,571,970,889,81,10
2021,Leicester 007,E02002833,2675,1282,779,503,6,6,620,60,560,767,696,71,0
2021,Leicester 008,E02002834,4699,2669,1437,1232,26,26,438,146,292,1565,1461,104,1
2021,Leicester 010,E02002836,3284,1454,926,528,13,13,712,317,395,1092,989,103,13
2021,Leicester 011,E02002837,2893,1279,513,766,6,6,955,802,153,645,588,57,8
2021,Leicester 012,E02002838,3091,1074,537,537,17,17,1538,1360,178,435,384,51,27
2021,Leicester 013,E02002839,3035,1857,887,970,23,23,687,567,120,453,400,53,15
2021,Leicester 016,E02002842,3482,868,473,395,23,23,561,228,333,2020,1888,132,10
2021,Leicester 017,E02002843,4029,1669,944,725,12,12,749,308,441,1575,1441,134,24
2021,Leicester 018,E02002844,3609,1208,823,385,11,11,1748,1298,450,623,545,78,19
2021,Leicester 019,E02002845,3864,1794,969,825,40,40,1215,874,341,792,708,84,23
2021,Leicester 020,E02002846,3047,2221,1160,1061,4,4,188,129,59,633,558,75,1
2021,Leicester 021,E02002847,2837,1831,1157,674,10,10,165,89,76,827,745,82,4
2021,Leicester 022,E02002848,3278,1244,816,428,5,5,709,191,518,1313,1204,109,7
2021,Leicester 023,E02002849,5181,1293,746,547,31,31,619,286,333,3228,3101,127,10
2021,Leicester 025,E02002851,2866,2322,1410,912,3,3,172,147,25,365,317,48,4
2021,Leicester 026,E02002852,2606,730,299,431,6,6,1648,1235,413,210,183,27,12
2021,Leicester 027,E02002853,4048,2177,1455,722,13,13,373,129,244,1480,1366,114,5
2021,Leicester 028,E02002854,3146,1308,542,766,17,17,1226,975,251,582,531,51,13
2021,Leicester 029,E02002855,3021,1340,749,591,20,20,149,73,76,1505,1417,88,7
2021,Leicester 030,E02002856,4953,2257,1288,969,19,19,290,99,191,2385,2258,127,2
2021,Leicester 031,E02002857,3243,1319,586,733,36,36,404,167,237,1483,1394,89,1
2021,Leicester 032,E02002858,2948,2318,1301,1017,4,4,81,43,38,545,500,45,0
2021,Leicester 034,E02002860,3445,2297,1170,1127,17,17,540,363,177,585,510,75,6
2021,Leicester 035,E02002861,2791,946,419,527,5,5,1521,1229,292,307,269,38,12
2021,Leicester 036,E02002862,3533,1466,650,816,8,8,1553,1410,143,480,433,47,26
2021,Rutland 001,E02002863,2875,1866,1157,709,46,46,253,43,210,710,367,343,0
2021,Rutland 002,E02002864,3553,2560,1420,1140,69,69,381,76,305,540,465,75,3
2021,Rutland 003,E02002865,3503,2436,1631,805,52,52,434,66,368,580,489,91,1
2021,Rutland 004,E02002866,3199,2452,1475,977,31,31,310,48,262,406,319,87,0
2021,Rutland 005,E02002867,3562,2530,1606,924,35,35,439,76,363,555,442,113,3
2021,Nottingham 001,E02002868,2519,1895,1108,787,15,15,369,210,159,238,195,43,2
2021,Nottingham 002,E02002869,3287,1285,624,661,9,9,1208,992,216,774,716,58,11
2021,Nottingham 004,E02002871,3516,2198,1160,1038,10,10,550,404,146,753,688,65,5
2021,Nottingham 005,E02002872,3753,1644,842,802,10,10,1445,1213,232,637,562,75,17
2021,Nottingham 006,E02002873,3848,1721,720,1001,10,10,1272,1143,129,826,760,66,19
2021,Nottingham 007,E02002874,3068,1936,944,992,4,4,645,556,89,476,413,63,7
2021,Nottingham 008,E02002875,3676,1656,711,945,14,14,1075,738,337,920,839,81,11
2021,Nottingham 009,E02002876,3416,1915,908,1007,27,27,737,490,247,728,634,94,9
2021,Nottingham 010,E02002877,3678,2137,1115,1022,11,11,399,212,187,1126,1049,77,5
2021,Nottingham 011,E02002878,3163,1050,422,628,3,3,1528,1448,80,573,494,79,9
2021,Nottingham 012,E02002879,4041,2159,928,1231,17,17,480,125,355,1377,1289,88,8
2021,Nottingham 013,E02002880,3219,1348,507,841,8,8,1232,1138,94,621,567,54,10
2021,Nottingham 014,E02002881,2764,1362,568,794,8,8,1024,738,286,363,296,67,7
2021,Nottingham 015,E02002882,3885,1776,891,885,30,30,377,178,199,1701,1627,74,1
2021,Nottingham 016,E02002883,3506,1544,700,844,27,27,1011,457,554,918,830,88,6
2021,Nottingham 017,E02002884,2518,844,438,406,9,9,291,57,234,1368,1301,67,6
2021,Nottingham 018,E02002885,3080,759,338,421,18,18,750,414,336,1547,1469,78,6
2021,Nottingham 019,E02002886,3669,2293,1047,1246,34,34,611,446,165,727,654,73,4
2021,Nottingham 020,E02002887,2753,1261,625,636,23,23,1115,954,161,339,300,39,15
2021,Nottingham 021,E02002888,3365,1166,549,617,14,14,1431,1156,275,729,668,61,25
2021,Nottingham 022,E02002889,2674,365,171,194,19,19,777,96,681,1511,1458,53,2
2021,Nottingham 023,E02002890,4198,748,394,354,6,6,1843,1385,458,1578,1501,77,23
2021,Nottingham 024,E02002891,3284,2238,1159,1079,7,7,504,439,65,522,446,76,13
2021,Nottingham 025,E02002892,2473,1330,625,705,5,5,799,649,150,330,279,51,9
2021,Nottingham 026,E02002893,4129,846,430,416,19,19,1339,864,475,1912,1793,119,13
2021,Nottingham 028,E02002895,3457,1109,581,528,15,15,385,168,217,1946,1867,79,2
2021,Nottingham 029,E02002896,4169,1325,573,752,12,12,1122,675,447,1693,1576,117,17
2021,Nottingham 030,E02002897,3233,2536,1590,946,3,3,322,93,229,370,329,41,2
2021,Nottingham 031,E02002898,3291,601,365,236,8,8,499,307,192,2175,2118,57,8
2021,Nottingham 034,E02002901,2681,1963,1039,924,11,11,317,227,90,387,334,53,3
2021,Nottingham 035,E02002902,3415,1793,944,849,5,5,916,824,92,689,611,78,12
2021,Nottingham 036,E02002903,2676,1354,751,603,129,129,794,572,222,389,341,48,10
2021,Nottingham 037,E02002904,2602,1461,718,743,4,4,649,585,64,484,424,60,4
2021,Herefordshire 001,E02002905,2770,2075,1475,600,14,14,184,19,165,497,392,105,0
2021,Herefordshire 002,E02002906,2519,1531,1015,516,18,18,459,74,385,510,448,62,1
2021,Herefordshire 003,E02002907,2937,1605,1034,571,33,33,522,57,465,777,695,82,0
2021,Herefordshire 004,E02002908,3920,2926,2036,890,43,43,295,24,271,656,491,165,0
2021,Herefordshire 005,E02002909,4859,3335,2232,1103,67,67,609,64,545,847,672,175,1
2021,Herefordshire 006,E02002910,3559,2379,1703,676,31,31,362,33,329,787,611,176,0
2021,Herefordshire 007,E02002911,3998,2799,1850,949,61,61,440,58,382,696,507,189,2
2021,Herefordshire 008,E02002912,3169,2409,1437,972,65,65,293,55,238,402,316,86,0
2021,Herefordshire 009,E02002913,2534,1934,1342,592,24,24,250,26,224,326,256,70,0
2021,Herefordshire 010,E02002914,4125,2621,1542,1079,52,52,545,140,405,903,807,96,4
2021,Herefordshire 011,E02002915,3416,2469,1424,1045,67,67,315,67,248,565,461,104,0
2021,Herefordshire 012,E02002916,4729,1927,1115,812,54,54,1189,275,914,1557,1408,149,2
2021,Herefordshire 013,E02002917,3105,2078,1157,921,24,24,285,60,225,718,648,70,0
2021,Herefordshire 014,E02002918,2419,1990,1239,751,13,13,176,36,140,240,194,46,0
2021,Herefordshire 015,E02002919,3892,2089,1057,1032,46,46,1090,407,683,661,468,193,6
2021,Herefordshire 016,E02002920,2851,1999,1143,856,44,44,254,93,161,550,485,65,4
2021,Herefordshire 017,E02002921,3267,1405,676,729,30,30,1413,505,908,412,342,70,7
2021,Herefordshire 018,E02002922,2790,2005,1311,694,32,32,269,51,218,482,400,82,2
2021,Herefordshire 019,E02002923,4472,2904,2020,884,67,67,584,90,494,916,813,103,1
2021,Herefordshire 020,E02002924,2620,1954,1395,559,14,14,200,52,148,451,347,104,1
2021,Herefordshire 021,E02002925,4586,3277,2045,1232,40,40,443,135,308,826,662,164,0
2021,Herefordshire 022,E02002926,5199,3267,2189,1078,51,51,807,235,572,1070,943,127,4
2021,Herefordshire 023,E02002927,5101,3988,2634,1354,25,25,330,102,228,758,578,180,0
2021,Telford and Wrekin 001,E02002928,2557,1762,1020,742,21,21,340,94,246,431,382,49,3
2021,Telford and Wrekin 002,E02002929,2453,1945,1160,785,13,13,165,51,114,329,248,81,1
2021,Telford and Wrekin 003,E02002930,3104,1953,1122,831,28,28,372,101,271,749,685,64,2
2021,Telford and Wrekin 004,E02002931,2696,2150,1163,987,11,11,211,58,153,323,270,53,1
2021,Telford and Wrekin 005,E02002932,3557,1684,776,908,11,11,999,467,532,860,749,111,3
2021,Telford and Wrekin 006,E02002933,3475,2520,1399,1121,15,15,408,152,256,531,459,72,1
2021,Telford and Wrekin 007,E02002934,2567,1757,907,850,16,16,365,119,246,427,394,33,2
2021,Telford and Wrekin 008,E02002935,2876,1849,1113,736,6,6,456,171,285,563,508,55,2
2021,Telford and Wrekin 009,E02002936,4172,2248,771,1477,39,39,898,347,551,982,889,93,5
2021,Telford and Wrekin 010,E02002937,4550,3481,1901,1580,42,42,340,100,240,684,590,94,3
2021,Telford and Wrekin 011,E02002938,2869,1474,768,706,7,7,602,236,366,784,713,71,2
2021,Telford and Wrekin 012,E02002939,3504,1969,1092,877,21,21,784,254,530,722,667,55,8
2021,Telford and Wrekin 013,E02002940,2713,1555,829,726,24,24,562,203,359,568,518,50,4
2021,Telford and Wrekin 014,E02002941,4652,2716,1335,1381,51,51,1027,376,651,851,781,70,7
2021,Telford and Wrekin 015,E02002942,3006,2209,1028,1181,41,41,327,79,248,429,336,93,0
2021,Telford and Wrekin 017,E02002944,3511,1390,666,724,25,25,1169,522,647,914,857,57,13
2021,Telford and Wrekin 018,E02002945,3762,1896,985,911,6,6,711,240,471,1143,1073,70,6
2021,Telford and Wrekin 019,E02002946,3491,2063,1079,984,29,29,712,259,453,681,609,72,6
2021,Telford and Wrekin 020,E02002947,2752,1411,755,656,6,6,451,152,299,882,835,47,2
2021,Telford and Wrekin 021,E02002948,2772,968,500,468,8,8,681,247,434,1112,1065,47,3
2021,Telford and Wrekin 022,E02002949,2567,1378,764,614,12,12,677,286,391,495,451,44,5
2021,Telford and Wrekin 023,E02002950,2394,1147,736,411,10,10,487,168,319,745,692,53,5
2021,Stoke-on-Trent 001,E02002951,3356,2337,1308,1029,4,4,636,498,138,364,306,58,15
2021,Stoke-on-Trent 002,E02002952,3091,1959,836,1123,2,2,644,577,67,471,415,56,15
2021,Stoke-on-Trent 003,E02002953,3149,1746,986,760,10,10,1070,763,307,314,267,47,9
2021,Stoke-on-Trent 004,E02002954,3598,2144,1205,939,4,4,959,865,94,475,393,82,16
2021,Stoke-on-Trent 005,E02002955,3045,1401,745,656,8,8,463,191,272,1164,1096,68,9
2021,Stoke-on-Trent 006,E02002956,3793,2184,1176,1008,12,12,815,700,115,772,700,72,10
2021,Stoke-on-Trent 007,E02002957,4227,3424,2041,1383,11,11,215,182,33,572,500,72,5
2021,Stoke-on-Trent 008,E02002958,3763,2252,1042,1210,1,1,792,617,175,698,624,74,20
2021,Stoke-on-Trent 009,E02002959,3989,1487,759,728,25,25,1127,524,603,1337,1193,144,13
2021,Stoke-on-Trent 010,E02002960,2466,1826,1074,752,10,10,370,349,21,255,212,43,5
2021,Stoke-on-Trent 011,E02002961,3004,1420,747,673,18,18,599,378,221,951,867,84,16
2021,Stoke-on-Trent 012,E02002962,3360,1343,662,681,15,15,1675,1086,589,308,268,40,19
2021,Stoke-on-Trent 013,E02002963,3413,1521,773,748,14,14,687,501,186,1181,1073,108,10
2021,Stoke-on-Trent 014,E02002964,3877,2504,1546,958,4,4,829,638,191,526,435,91,14
2021,Stoke-on-Trent 015,E02002965,2925,1035,505,530,10,10,731,259,472,1137,1041,96,12
2021,Stoke-on-Trent 016,E02002966,4216,1546,708,838,36,36,952,431,521,1669,1573,96,13
2021,Stoke-on-Trent 017,E02002967,4249,1237,652,585,19,19,2441,1351,1090,538,455,83,14
2021,Stoke-on-Trent 018,E02002968,4158,2358,1219,1139,27,27,507,260,247,1261,1166,95,5
2021,Stoke-on-Trent 019,E02002969,4324,1907,944,963,25,25,827,407,420,1556,1457,99,9
2021,Stoke-on-Trent 020,E02002970,3793,1822,967,855,7,7,749,518,231,1180,1083,97,35
2021,Stoke-on-Trent 023,E02002973,3427,1796,873,923,7,7,845,452,393,773,715,58,6
2021,Stoke-on-Trent 024,E02002974,2610,2029,1199,830,29,29,323,202,121,224,200,24,5
2021,Stoke-on-Trent 025,E02002975,3145,2706,1383,1323,22,22,104,82,22,312,253,59,1
2021,Stoke-on-Trent 026,E02002976,2386,1670,928,742,3,3,466,452,14,243,205,38,4
2021,Stoke-on-Trent 027,E02002977,2706,1614,1000,614,8,8,655,582,73,410,362,48,19
2021,Stoke-on-Trent 028,E02002978,2950,1341,694,647,20,20,1018,834,184,559,487,72,12
2021,Stoke-on-Trent 029,E02002979,2163,1217,644,573,16,16,274,125,149,649,549,100,7
2021,Stoke-on-Trent 030,E02002980,2672,2176,1341,835,7,7,268,231,37,216,175,41,5
2021,Stoke-on-Trent 031,E02002981,3330,2000,950,1050,4,4,911,714,197,407,347,60,8
2021,Stoke-on-Trent 032,E02002982,3648,1742,701,1041,3,3,1418,1264,154,466,418,48,19
2021,Stoke-on-Trent 033,E02002983,2256,1972,1123,849,6,6,90,81,9,187,150,37,1
2021,Stoke-on-Trent 034,E02002984,2259,2036,1180,856,6,6,45,21,24,172,143,29,0
2021,Bath and North East Somerset 001,E02002985,2861,1908,979,929,49,49,492,152,340,409,351,58,3
2021,Bath and North East Somerset 002,E02002986,3141,2012,961,1051,69,69,722,202,520,334,284,50,4
2021,Bath and North East Somerset 003,E02002987,2480,2075,1237,838,13,13,123,30,93,268,230,38,1
2021,Bath and North East Somerset 004,E02002988,2452,1723,997,726,19,19,276,76,200,434,389,45,0
2021,Bath and North East Somerset 005,E02002989,2362,1576,914,662,22,22,381,97,284,382,346,36,1
2021,Bath and North East Somerset 006,E02002990,2779,1539,857,682,8,8,358,96,262,874,813,61,0
2021,Bath and North East Somerset 007,E02002991,5466,2348,1445,903,59,59,884,143,741,2173,2008,165,2
2021,Bath and North East Somerset 008,E02002992,2427,1555,838,717,26,26,379,64,315,463,418,45,4
2021,Bath and North East Somerset 009,E02002993,2560,1030,570,460,10,10,473,70,403,1046,986,60,1
2021,Bath and North East Somerset 010,E02002994,4319,3419,2030,1389,9,9,343,92,251,548,439,109,0
2021,Bath and North East Somerset 011,E02002995,2392,861,438,423,21,21,1094,366,728,409,373,36,7
2021,Bath and North East Somerset 012,E02002996,3586,2306,1494,812,36,36,198,40,158,1046,972,74,0
2021,Bath and North East Somerset 013,E02002997,3124,1332,698,634,54,54,375,98,277,1361,1308,53,2
2021,Bath and North East Somerset 014,E02002998,2275,1119,610,509,9,9,471,144,327,674,634,40,2
2021,Bath and North East Somerset 015,E02002999,2333,1449,844,605,16,16,507,175,332,357,316,41,4
2021,Bath and North East Somerset 016,E02003000,4016,3228,1968,1260,17,17,408,120,288,363,295,68,0
2021,Bath and North East Somerset 017,E02003001,2228,1696,973,723,18,18,163,17,146,351,320,31,0
2021,Bath and North East Somerset 018,E02003002,2665,1614,911,703,33,33,646,207,439,364,310,54,8
2021,Bath and North East Somerset 019,E02003003,2362,1472,774,698,35,35,401,95,306,452,405,47,2
2021,Bath and North East Somerset 020,E02003004,2889,2198,1120,1078,49,49,344,86,258,295,245,50,3
2021,Bath and North East Somerset 021,E02003005,2679,2156,1278,878,22,22,211,43,168,288,222,66,2
2021,Bath and North East Somerset 022,E02003006,3606,2649,1398,1251,28,28,371,117,254,556,476,80,2
2021,Bath and North East Somerset 023,E02003007,3951,2994,1593,1401,63,63,419,134,285,473,400,73,2
2021,Bath and North East Somerset 024,E02003008,2554,1663,755,908,15,15,493,155,338,381,342,39,2
2021,Bath and North East Somerset 025,E02003009,2663,2092,1130,962,17,17,153,52,101,401,356,45,0
2021,Bath and North East Somerset 026,E02003010,2611,1915,962,953,46,46,312,106,206,337,292,45,1
2021,Bath and North East Somerset 027,E02003011,2463,1799,1078,721,29,29,365,85,280,267,225,42,3
2021,Bristol 001,E02003012,5059,2606,1250,1356,44,44,1614,1391,223,779,693,86,16
2021,Bristol 002,E02003013,4806,2351,1119,1232,38,38,1541,1319,222,849,766,83,27
2021,Bristol 003,E02003014,3357,1372,620,752,8,8,1615,1357,258,340,290,50,22
2021,Bristol 004,E02003015,2771,1529,752,777,12,12,582,492,90,639,584,55,9
2021,Bristol 005,E02003016,3065,1173,524,649,45,45,932,452,480,907,865,42,8
2021,Bristol 006,E02003017,2744,1934,1067,867,16,16,344,248,96,446,376,70,4
2021,Bristol 007,E02003018,2493,1590,807,783,10,10,670,600,70,210,171,39,13
2021,Bristol 008,E02003019,4259,2531,1198,1333,16,16,870,721,149,830,749,81,12
2021,Bristol 009,E02003020,2503,2082,1174,908,12,12,150,45,105,258,225,33,1
2021,Bristol 010,E02003021,2733,1739,760,979,22,22,149,115,34,820,767,53,3
2021,Bristol 011,E02003022,2442,2195,1290,905,4,4,42,26,16,201,169,32,0
2021,Bristol 012,E02003023,2612,1613,907,706,8,8,486,352,134,498,441,57,7
2021,Bristol 013,E02003024,4016,2261,1082,1179,50,50,787,486,301,909,812,97,9
2021,Bristol 014,E02003025,2902,1612,718,894,21,21,722,569,153,533,485,48,14
2021,Bristol 015,E02003026,3293,2700,1592,1108,8,8,142,109,33,442,382,60,1
2021,Bristol 016,E02003027,5025,3348,1470,1878,24,24,192,74,118,1461,1354,107,0
2021,Bristol 017,E02003028,3439,2297,1139,1158,5,5,182,66,116,954,895,59,1
2021,Bristol 018,E02003029,2514,1436,636,800,6,6,672,570,102,393,343,50,7
2021,Bristol 019,E02003030,3250,1893,844,1049,25,25,295,131,164,1026,942,84,11
2021,Bristol 020,E02003031,4102,2305,1045,1260,15,15,158,44,114,1622,1544,78,2
2021,Bristol 021,E02003032,3371,2015,837,1178,49,49,465,258,207,839,754,85,3
2021,Bristol 022,E02003033,3501,1453,706,747,16,16,185,51,134,1846,1782,64,1
2021,Bristol 025,E02003036,3616,1223,548,675,17,17,503,332,171,1863,1761,102,10
2021,Bristol 026,E02003037,3988,1523,733,790,12,12,150,47,103,2303,2192,111,0
2021,Bristol 027,E02003038,2954,1829,807,1022,15,15,363,206,157,743,666,77,4
2021,Bristol 028,E02003039,3771,2175,863,1312,14,14,656,447,209,913,832,81,13
2021,Bristol 029,E02003040,4645,2427,818,1609,26,26,468,263,205,1717,1597,120,7
2021,Bristol 030,E02003041,2875,1286,786,500,6,6,109,40,69,1474,1383,91,0
2021,Bristol 033,E02003044,2659,1959,919,1040,10,10,120,54,66,569,513,56,1
2021,Bristol 034,E02003045,2845,1188,624,564,29,29,398,205,193,1223,1171,52,7
2021,Bristol 035,E02003046,4354,2745,997,1748,36,36,568,320,248,1001,925,76,4
2021,Bristol 036,E02003047,4741,2660,1073,1587,27,27,636,440,196,1413,1318,95,5
2021,Bristol 037,E02003048,3153,1743,617,1126,60,60,334,83,251,1014,947,67,2
2021,Bristol 038,E02003049,3301,2207,1027,1180,10,10,526,479,47,551,488,63,7
2021,Bristol 039,E02003050,4945,2202,811,1391,49,49,906,540,366,1780,1658,122,8
2021,Bristol 040,E02003051,2996,1664,620,1044,36,36,629,463,166,663,617,46,4
2021,Bristol 041,E02003052,3031,2150,938,1212,7,7,290,265,25,583,528,55,1
2021,Bristol 042,E02003053,3449,2461,1152,1309,34,34,319,161,158,634,567,67,1
2021,Bristol 043,E02003054,2824,1968,938,1030,24,24,332,260,72,495,441,54,5
2021,Bristol 044,E02003055,3288,1662,696,966,89,89,1165,1036,129,361,329,32,11
2021,Bristol 045,E02003056,2923,1361,581,780,9,9,1146,994,152,379,333,46,28
2021,Bristol 046,E02003057,2549,1859,912,947,13,13,287,235,52,381,330,51,9
2021,Bristol 047,E02003058,4074,2538,1223,1315,70,70,849,487,362,596,528,68,21
2021,Bristol 048,E02003059,2875,1698,828,870,101,101,566,391,175,504,449,55,6
2021,Bristol 049,E02003060,4668,3192,1691,1501,26,26,944,634,310,496,416,80,10
2021,Bristol 050,E02003061,2499,1173,567,606,14,14,1012,823,189,292,244,48,8
2021,Bristol 051,E02003062,2382,1076,522,554,20,20,1049,802,247,231,191,40,6
2021,Bristol 052,E02003063,2982,2563,1526,1037,12,12,125,81,44,279,233,46,3
2021,Bristol 053,E02003064,2983,974,478,496,28,28,1631,1352,279,325,290,35,25
2021,North Somerset 001,E02003065,4598,3055,1687,1368,58,58,497,97,400,985,880,105,3
2021,North Somerset 002,E02003066,2619,2295,1396,899,12,12,80,9,71,232,198,34,0
2021,North Somerset 003,E02003067,3457,2663,1320,1343,49,49,290,40,250,455,399,56,0
2021,North Somerset 004,E02003068,2732,2046,1141,905,6,6,326,109,217,348,286,62,6
2021,North Somerset 005,E02003069,2506,2040,1266,774,7,7,37,5,32,422,369,53,0
2021,North Somerset 006,E02003070,5415,4461,2352,2109,29,29,346,69,277,577,479,98,2
2021,North Somerset 007,E02003071,3718,2412,1370,1042,36,36,579,108,471,688,614,74,3
2021,North Somerset 008,E02003072,4250,3303,2074,1229,13,13,392,88,304,536,457,79,6
2021,North Somerset 009,E02003073,2658,2288,1445,843,6,6,87,13,74,277,241,36,0
2021,North Somerset 010,E02003074,3455,2640,1452,1188,20,20,169,40,129,626,569,57,0
2021,North Somerset 011,E02003075,2399,1999,1098,901,7,7,133,26,107,260,220,40,0
2021,North Somerset 012,E02003076,4137,3284,1773,1511,45,45,368,76,292,440,384,56,0
2021,North Somerset 013,E02003077,2606,2131,1192,939,16,16,123,23,100,335,278,57,1
2021,North Somerset 014,E02003078,3098,2422,1419,1003,7,7,211,47,164,456,399,57,2
2021,North Somerset 015,E02003079,3867,2978,1436,1542,20,20,182,45,137,687,602,85,0
2021,North Somerset 016,E02003080,4003,2891,1811,1080,42,42,439,83,356,631,532,99,0
2021,North Somerset 017,E02003081,4145,3390,2001,1389,12,12,211,61,150,531,462,69,1
2021,North Somerset 018,E02003082,4661,2606,1548,1058,14,14,207,38,169,1833,1687,146,1
2021,North Somerset 020,E02003084,5184,2337,1234,1103,30,30,577,110,467,2240,2112,128,0
2021,North Somerset 021,E02003085,3458,1203,568,635,22,22,1627,535,1092,584,524,60,22
2021,North Somerset 022,E02003086,2791,1726,991,735,6,6,177,11,166,882,801,81,0
2021,North Somerset 023,E02003087,4716,3835,2183,1652,46,46,304,71,233,531,461,70,0
2021,North Somerset 024,E02003088,3761,2957,1838,1119,43,43,283,66,217,477,394,83,1
2021,North Somerset 025,E02003089,2598,1810,1110,700,10,10,403,141,262,372,320,52,3
2021,South Gloucestershire 001,E02003090,3758,2944,1553,1391,52,52,350,75,275,411,351,60,1
2021,South Gloucestershire 002,E02003091,2908,2172,1278,894,14,14,382,80,302,340,303,37,0
2021,South Gloucestershire 003,E02003092,3260,2567,1285,1282,41,41,312,49,263,340,263,77,0
2021,South Gloucestershire 004,E02003093,2788,2321,1482,839,4,4,137,24,113,325,266,59,1
2021,South Gloucestershire 005,E02003094,3568,2800,1461,1339,37,37,278,52,226,451,393,58,2
2021,South Gloucestershire 006,E02003095,3442,2687,1295,1392,63,63,334,29,305,358,315,43,0
2021,South Gloucestershire 007,E02003096,2712,1908,928,980,6,6,315,76,239,483,436,47,0
2021,South Gloucestershire 008,E02003097,2884,2284,1398,886,28,28,257,61,196,315,271,44,0
2021,South Gloucestershire 009,E02003098,4076,2697,1087,1610,12,12,47,6,41,1320,1254,66,0
2021,South Gloucestershire 010,E02003099,3187,2452,1305,1147,29,29,314,46,268,391,343,48,1
2021,South Gloucestershire 012,E02003101,4345,2635,1052,1583,14,14,341,15,326,1354,1272,82,1
2021,South Gloucestershire 013,E02003102,2829,2289,1251,1038,26,26,311,55,256,203,174,29,0
2021,South Gloucestershire 014,E02003103,2861,2209,974,1235,8,8,120,22,98,523,466,57,1
2021,South Gloucestershire 015,E02003104,3176,2354,1232,1122,21,21,343,68,275,456,407,49,2
2021,South Gloucestershire 016,E02003105,2604,2083,1204,879,4,4,250,56,194,265,220,45,2
2021,South Gloucestershire 018,E02003107,4590,2718,1450,1268,48,48,615,96,519,1205,1125,80,4
2021,South Gloucestershire 019,E02003108,5041,3724,1697,2027,138,138,604,80,524,571,502,69,4
2021,South Gloucestershire 020,E02003109,2442,2210,1219,991,2,2,73,16,57,157,129,28,0
2021,South Gloucestershire 021,E02003110,4774,3489,1405,2084,47,47,276,26,250,962,790,172,0
2021,South Gloucestershire 022,E02003111,2750,2182,1171,1011,10,10,203,33,170,354,307,47,1
2021,South Gloucestershire 023,E02003112,2664,1667,798,869,10,10,708,124,584,277,235,42,2
2021,South Gloucestershire 024,E02003113,4295,3200,1896,1304,13,13,417,68,349,665,519,146,0
2021,South Gloucestershire 025,E02003114,3182,2294,1284,1010,16,16,419,74,345,453,394,59,0
2021,South Gloucestershire 026,E02003115,4236,2719,1291,1428,40,40,539,99,440,935,837,98,3
2021,South Gloucestershire 027,E02003116,3321,1977,983,994,12,12,866,153,713,463,412,51,3
2021,South Gloucestershire 028,E02003117,3925,2620,1239,1381,84,84,493,77,416,725,633,92,3
2021,South Gloucestershire 029,E02003118,4204,3171,1584,1587,30,30,347,54,293,652,578,74,4
2021,South Gloucestershire 030,E02003119,4205,2959,1476,1483,13,13,778,142,636,451,393,58,4
2021,South Gloucestershire 031,E02003120,3840,3058,1710,1348,29,29,344,54,290,408,346,62,1
2021,South Gloucestershire 032,E02003121,4411,3809,2229,1580,30,30,116,15,101,455,385,70,1
2021,Plymouth 001,E02003122,3150,2546,1652,894,37,37,186,68,118,381,243,138,0
2021,Plymouth 002,E02003123,3736,2033,1037,996,98,98,1147,513,634,454,391,63,4
2021,Plymouth 003,E02003124,3547,1864,853,1011,84,84,1098,515,583,489,430,59,12
2021,Plymouth 004,E02003125,2733,1485,805,680,19,19,869,411,458,345,302,43,15
2021,Plymouth 005,E02003126,3468,2220,1106,1114,30,30,720,230,490,491,415,76,7
2021,Plymouth 006,E02003127,3075,1710,853,857,40,40,923,472,451,383,330,53,19
2021,Plymouth 007,E02003128,4092,2063,955,1108,71,71,1302,605,697,638,551,87,18
2021,Plymouth 008,E02003129,2815,1833,1029,804,11,11,454,110,344,517,238,279,0
2021,Plymouth 009,E02003130,4527,2601,1322,1279,18,18,1171,359,812,737,638,99,0
2021,Plymouth 010,E02003131,3184,1975,978,997,22,22,738,283,455,442,370,72,7
2021,Plymouth 011,E02003132,3740,2577,1219,1358,36,36,625,302,323,493,408,85,9
2021,Plymouth 012,E02003133,3056,2299,1223,1076,14,14,423,134,289,319,271,48,1
2021,Plymouth 013,E02003134,2880,1494,635,859,114,114,879,439,440,383,317,66,10
2021,Plymouth 014,E02003135,2931,1332,604,728,57,57,902,269,633,637,565,72,3
2021,Plymouth 015,E02003136,3327,2747,1663,1084,18,18,168,49,119,394,334,60,0
2021,Plymouth 016,E02003137,3164,2551,1302,1249,8,8,212,30,182,393,309,84,0
2021,Plymouth 017,E02003138,3219,2323,1053,1270,14,14,48,9,39,833,772,61,1
2021,Plymouth 018,E02003139,2735,2059,919,1140,48,48,164,16,148,464,410,54,0
2021,Plymouth 019,E02003140,3245,2724,1387,1337,38,38,122,28,94,360,296,64,1
2021,Plymouth 020,E02003141,3781,2005,853,1152,13,13,332,65,267,1431,1342,89,0
2021,Plymouth 021,E02003142,4007,2224,1028,1196,49,49,1025,332,693,703,563,140,6
2021,Plymouth 022,E02003143,3284,2224,1198,1026,20,20,479,102,377,559,424,135,2
2021,Plymouth 023,E02003144,3211,1065,515,550,19,19,99,18,81,2027,1943,84,1
2021,Plymouth 024,E02003145,2863,1692,847,845,32,32,351,106,245,784,717,67,4
2021,Plymouth 025,E02003146,3514,1692,728,964,16,16,210,60,150,1595,1468,127,1
2021,Plymouth 026,E02003147,4347,1160,500,660,96,96,1892,672,1220,1195,1105,90,4
2021,Plymouth 027,E02003148,4425,920,555,365,39,39,1436,417,1019,2025,1898,127,5
2021,Plymouth 028,E02003149,4327,1505,723,782,51,51,740,96,644,2030,1902,128,1
2021,Plymouth 030,E02003151,3564,2945,1817,1128,78,78,221,66,155,318,230,88,2
2021,Plymouth 031,E02003152,4767,3728,1877,1851,72,72,307,104,203,660,538,122,0
2021,Plymouth 032,E02003153,3335,2421,1420,1001,35,35,152,34,118,726,472,254,1
2021,Torbay 001,E02003154,3041,1914,1132,782,19,19,680,92,588,426,369,57,2
2021,Torbay 002,E02003155,2720,1730,1088,642,17,17,145,12,133,827,756,71,1
2021,Torbay 003,E02003156,4408,2768,1392,1376,87,87,474,54,420,1078,964,114,1
2021,Torbay 004,E02003157,3064,1556,829,727,44,44,419,49,370,1042,953,89,3
2021,Torbay 005,E02003158,2618,1682,1072,610,5,5,182,21,161,749,670,79,0
2021,Torbay 006,E02003159,2590,1545,750,795,15,15,76,6,70,953,875,78,1
2021,Torbay 008,E02003161,3954,1406,817,589,38,38,381,45,336,2124,2005,119,5
2021,Torbay 010,E02003163,4341,2687,1902,785,23,23,175,9,166,1455,1351,104,1
2021,Torbay 011,E02003164,3922,3129,1914,1215,22,22,102,10,92,669,582,87,0
2021,Torbay 012,E02003165,3073,2367,1287,1080,11,11,78,10,68,616,539,77,1
2021,Torbay 013,E02003166,5193,3230,1679,1551,153,153,973,129,844,836,752,84,1
2021,Torbay 014,E02003167,5018,2369,1597,772,34,34,367,21,346,2248,2069,179,0
2021,Torbay 015,E02003168,3290,2357,1502,855,77,77,265,10,255,591,515,76,0
2021,Torbay 016,E02003169,3032,2635,1855,780,9,9,83,4,79,305,257,48,0
2021,Torbay 017,E02003170,4641,3249,2324,925,34,34,277,24,253,1081,950,131,0
2021,Torbay 018,E02003171,3301,2391,1591,800,24,24,266,32,234,620,539,81,0
2021,"Bournemouth, Christchurch and Poole 003",E02003172,2759,1837,1062,775,18,18,549,354,195,353,305,48,2
2021,"Bournemouth, Christchurch and Poole 005",E02003173,3072,2071,1203,868,7,7,588,491,97,400,338,62,6
2021,"Bournemouth, Christchurch and Poole 006",E02003174,3611,2849,1626,1223,17,17,194,102,92,549,485,64,2
2021,"Bournemouth, Christchurch and Poole 007",E02003175,3833,2678,1307,1371,43,43,299,166,133,812,734,78,1
2021,"Bournemouth, Christchurch and Poole 010",E02003176,3047,1288,599,689,23,23,1346,1104,242,371,326,45,19
2021,"Bournemouth, Christchurch and Poole 009",E02003177,3288,2631,1187,1444,10,10,54,11,43,593,550,43,0
2021,"Bournemouth, Christchurch and Poole 011",E02003178,3545,2251,1117,1134,19,19,511,381,130,758,684,74,6
2021,"Bournemouth, Christchurch and Poole 012",E02003179,2768,1497,824,673,13,13,869,625,244,376,339,37,13
2021,"Bournemouth, Christchurch and Poole 015",E02003180,3821,1751,756,995,20,20,385,157,228,1663,1585,78,2
2021,"Bournemouth, Christchurch and Poole 017",E02003181,3441,2382,1067,1315,8,8,156,33,123,895,823,72,0
2021,"Bournemouth, Christchurch and Poole 020",E02003182,2635,2069,1046,1023,4,4,82,37,45,479,403,76,1
2021,"Bournemouth, Christchurch and Poole 028",E02003183,2867,1812,1023,789,4,4,147,19,128,904,847,57,0
2021,"Bournemouth, Christchurch and Poole 027",E02003184,3246,1547,611,936,24,24,115,28,87,1559,1466,93,1
2021,"Bournemouth, Christchurch and Poole 026",E02003185,3095,2215,1012,1203,13,13,322,187,135,542,484,58,3
2021,"Bournemouth, Christchurch and Poole 025",E02003186,3843,1829,668,1161,13,13,399,104,295,1597,1505,92,5
2021,"Bournemouth, Christchurch and Poole 035",E02003187,4138,2234,1088,1146,40,40,269,41,228,1593,1503,90,2
2021,"Bournemouth, Christchurch and Poole 038",E02003188,5762,1922,979,943,29,29,645,290,355,3162,3006,156,4
2021,"Bournemouth, Christchurch and Poole 036",E02003189,4079,2403,1302,1101,11,11,284,40,244,1381,1263,118,0
2021,"Bournemouth, Christchurch and Poole 037",E02003190,5531,1578,685,893,66,66,547,177,370,3337,3200,137,3
2021,"Bournemouth, Christchurch and Poole 039",E02003191,3943,3039,1962,1077,8,8,159,41,118,735,653,82,2
2021,"Bournemouth, Christchurch and Poole 041",E02003192,5262,1743,997,746,26,26,534,198,336,2957,2800,157,2
2021,"Bournemouth, Christchurch and Poole 001",E02003194,2478,2166,1409,757,8,8,87,41,46,217,179,38,0
2021,"Bournemouth, Christchurch and Poole 008",E02003195,2333,1728,758,970,14,14,294,214,80,295,249,46,2
2021,"Bournemouth, Christchurch and Poole 004",E02003196,4275,3882,2397,1485,5,5,89,57,32,296,243,53,3
2021,"Bournemouth, Christchurch and Poole 013",E02003197,2890,1929,1023,906,26,26,507,235,272,426,388,38,2
2021,"Bournemouth, Christchurch and Poole 016",E02003198,3054,2142,1009,1133,31,31,290,20,270,591,547,44,0
2021,"Bournemouth, Christchurch and Poole 021",E02003199,4095,2987,1551,1436,14,14,488,329,159,598,525,73,8
2021,"Bournemouth, Christchurch and Poole 022",E02003200,4168,2667,1337,1330,24,24,810,575,235,665,590,75,2
2021,"Bournemouth, Christchurch and Poole 023",E02003201,4702,2933,1320,1613,64,64,778,484,294,913,837,76,14
2021,"Bournemouth, Christchurch and Poole 029",E02003202,2660,1621,830,791,11,11,367,20,347,661,605,56,0
2021,"Bournemouth, Christchurch and Poole 032",E02003203,3261,2315,1037,1278,26,26,208,62,146,710,645,65,2
2021,"Bournemouth, Christchurch and Poole 030",E02003204,4041,2625,1312,1313,17,17,531,243,288,866,789,77,2
2021,"Bournemouth, Christchurch and Poole 034",E02003205,3414,2748,1481,1267,17,17,255,179,76,391,326,65,3
2021,"Bournemouth, Christchurch and Poole 043",E02003206,4335,3099,1571,1528,6,6,195,55,140,1034,964,70,1
2021,"Bournemouth, Christchurch and Poole 042",E02003207,2972,1705,860,845,13,13,612,416,196,639,465,174,3
2021,"Bournemouth, Christchurch and Poole 044",E02003208,5570,2475,1558,917,146,146,1151,532,619,1789,1654,135,9
2021,"Bournemouth, Christchurch and Poole 046",E02003209,3003,1880,1004,876,40,40,479,230,249,600,528,72,4
2021,"Bournemouth, Christchurch and Poole 047",E02003210,4636,3411,1952,1459,27,27,166,54,112,1030,939,91,2
2021,"Bournemouth, Christchurch and Poole 048",E02003211,4323,3320,2467,853,12,12,96,21,75,895,778,117,0
2021,Swindon 001,E02003212,3745,2704,1573,1131,17,17,535,375,160,483,414,69,6
2021,Swindon 003,E02003214,2811,1002,511,491,14,14,1571,1492,79,213,185,28,11
2021,Swindon 004,E02003215,3048,2475,1448,1027,15,15,192,96,96,365,329,36,1
2021,Swindon 005,E02003216,4274,3021,1595,1426,30,30,731,525,206,479,404,75,13
2021,Swindon 006,E02003217,3020,1784,799,985,36,36,794,643,151,402,347,55,4
2021,Swindon 007,E02003218,2552,1342,663,679,3,3,954,812,142,243,201,42,10
2021,Swindon 008,E02003219,4948,3660,1346,2314,275,275,609,196,413,399,329,70,5
2021,Swindon 009,E02003220,4453,3423,1852,1571,43,43,374,141,233,606,542,64,7
2021,Swindon 010,E02003221,2881,1601,654,947,4,4,512,372,140,754,671,83,10
2021,Swindon 011,E02003222,2513,1801,775,1026,19,19,189,99,90,502,465,37,2
2021,Swindon 012,E02003223,4650,2781,1086,1695,31,31,279,112,167,1558,1477,81,1
2021,Swindon 013,E02003224,3815,3113,1800,1313,31,31,179,90,89,489,413,76,3
2021,Swindon 014,E02003225,2834,1911,921,990,30,30,122,32,90,763,692,71,8
2021,Swindon 015,E02003226,3738,1314,421,893,9,9,575,446,129,1831,1718,113,9
2021,Swindon 016,E02003227,2789,823,354,469,81,81,1591,1347,244,276,248,28,18
2021,Swindon 017,E02003228,2921,2066,1005,1061,20,20,187,15,172,648,586,62,0
2021,Swindon 018,E02003229,2361,1731,813,918,42,42,193,35,158,394,369,25,1
2021,Swindon 019,E02003230,3907,1560,634,926,52,52,255,65,190,2038,1934,104,2
2021,Swindon 020,E02003231,3269,1491,648,843,22,22,1363,1230,133,373,305,68,20
2021,Swindon 021,E02003232,3599,2362,994,1368,83,83,187,76,111,966,889,77,1
2021,Swindon 022,E02003233,3743,2101,1032,1069,15,15,1114,734,380,502,430,72,11
2021,Swindon 023,E02003234,3568,2402,1267,1135,10,10,756,328,428,397,350,47,3
2021,Swindon 024,E02003235,4114,2880,1519,1361,113,113,379,24,355,739,677,62,3
2021,Swindon 025,E02003236,5310,3992,2043,1949,55,55,763,446,317,495,397,98,5
2021,Peterborough 001,E02003237,2665,2134,1250,884,17,17,182,47,135,331,283,48,1
2021,Peterborough 002,E02003238,2468,1565,738,827,31,31,375,81,294,497,463,34,0
2021,Peterborough 003,E02003239,3543,2827,1588,1239,25,25,212,84,128,479,417,62,0
2021,Peterborough 004,E02003240,2708,1774,871,903,29,29,253,64,189,651,388,263,1
2021,Peterborough 005,E02003241,3049,2088,1009,1079,41,41,417,110,307,499,419,80,4
2021,Peterborough 006,E02003242,3768,2631,1531,1100,26,26,527,151,376,580,525,55,4
2021,Peterborough 007,E02003243,4810,1836,660,1176,142,142,2054,819,1235,764,701,63,14
2021,Peterborough 008,E02003244,3788,1734,789,945,61,61,1325,503,822,661,591,70,7
2021,Peterborough 009,E02003245,3058,1054,489,565,26,26,1202,457,745,765,712,53,11
2021,Peterborough 010,E02003246,3200,1409,641,768,15,15,530,181,349,1246,1143,103,0
2021,Peterborough 011,E02003247,3500,1609,886,723,38,38,980,287,693,868,804,64,5
2021,Peterborough 012,E02003248,3465,1969,980,989,24,24,286,77,209,1182,1087,95,4
2021,Peterborough 013,E02003249,5016,2284,1092,1192,95,95,1331,489,842,1293,1197,96,13
2021,Peterborough 014,E02003250,4693,1479,830,649,43,43,599,176,423,2564,2396,168,8
2021,Peterborough 015,E02003251,3057,2422,1464,958,20,20,186,43,143,428,364,64,1
2021,Peterborough 016,E02003252,4765,2323,904,1419,79,79,619,177,442,1737,1624,113,7
2021,Peterborough 017,E02003253,4541,2135,959,1176,83,83,844,215,629,1475,1370,105,4
2021,Peterborough 018,E02003254,4069,3031,1751,1280,29,29,338,90,248,671,592,79,0
2021,Peterborough 019,E02003255,5587,3690,1534,2156,111,111,872,265,607,912,823,89,2
2021,Peterborough 021,E02003257,3774,1403,640,763,15,15,1311,435,876,1034,958,76,11
2021,Luton 001,E02003258,3487,2772,1495,1277,7,7,132,83,49,575,534,41,1
2021,Luton 002,E02003259,2613,1761,878,883,9,9,398,273,125,440,400,40,5
2021,Luton 003,E02003260,3257,1374,568,806,20,20,1290,1101,189,559,497,62,14
2021,Luton 004,E02003261,2477,1804,1049,755,7,7,316,252,64,349,295,54,1
2021,Luton 005,E02003262,4065,2141,990,1151,28,28,1277,908,369,617,559,58,2
2021,Luton 006,E02003263,4488,2824,1408,1416,20,20,396,309,87,1240,1156,84,8
2021,Luton 007,E02003264,3202,2641,1248,1393,4,4,37,10,27,520,471,49,0
2021,Luton 008,E02003265,3501,2533,1359,1174,8,8,381,283,98,574,518,56,5
2021,Luton 009,E02003266,3647,1830,720,1110,12,12,1258,992,266,535,484,51,12
2021,Luton 010,E02003267,3682,2248,912,1336,8,8,253,106,147,1167,1063,104,6
2021,Luton 011,E02003268,3747,2211,939,1272,17,17,459,88,371,1059,967,92,1
2021,Luton 012,E02003269,4204,2693,1366,1327,15,15,336,188,148,1159,1076,83,1
2021,Luton 013,E02003270,3091,2087,1118,969,17,17,279,192,87,708,643,65,0
2021,Luton 014,E02003271,4023,2719,1304,1415,16,16,326,142,184,959,894,65,3
2021,Luton 015,E02003272,2831,1643,780,863,58,58,309,78,231,818,731,87,3
2021,Luton 016,E02003273,4310,2515,1061,1454,38,38,865,710,155,884,817,67,8
2021,Luton 017,E02003274,3362,1220,588,632,11,11,575,249,326,1549,1444,105,7
2021,Luton 019,E02003276,2728,1061,490,571,14,14,276,70,206,1375,1297,78,2
2021,Luton 020,E02003277,3967,1755,778,977,35,35,1233,911,322,930,853,77,14
2021,Luton 021,E02003278,5256,1509,693,816,36,36,1008,533,475,2691,2587,104,12
2021,Southend-on-Sea 001,E02003279,4057,3379,1987,1392,8,8,163,80,83,507,427,80,0
2021,Southend-on-Sea 002,E02003280,4480,3178,1676,1502,39,39,605,438,167,655,579,76,3
2021,Southend-on-Sea 003,E02003281,4204,3211,1909,1302,9,9,410,313,97,568,478,90,6
2021,Southend-on-Sea 004,E02003282,4446,3045,1563,1482,7,7,426,222,204,966,887,79,2
2021,Southend-on-Sea 005,E02003283,4446,3009,1473,1536,30,30,746,589,157,657,573,84,4
2021,Southend-on-Sea 006,E02003284,4639,2938,1315,1623,24,24,478,339,139,1191,1094,97,8
2021,Southend-on-Sea 007,E02003285,4628,2649,1025,1624,13,13,97,33,64,1868,1719,149,1
2021,Southend-on-Sea 008,E02003286,3852,3114,1613,1501,7,7,109,55,54,622,569,53,0
2021,Southend-on-Sea 009,E02003287,4193,2671,1609,1062,22,22,840,456,384,655,586,69,5
2021,Southend-on-Sea 010,E02003288,5974,2027,860,1167,147,147,1450,844,606,2346,2180,166,4
2021,Southend-on-Sea 011,E02003289,4708,3127,1451,1676,10,10,83,42,41,1488,1341,147,0
2021,Southend-on-Sea 012,E02003290,4472,2621,1341,1280,25,25,216,90,126,1608,1515,93,2
2021,Southend-on-Sea 013,E02003291,5141,2919,1482,1437,59,59,1143,465,678,1018,924,94,2
2021,Southend-on-Sea 014,E02003292,5557,1846,786,1060,54,54,1338,322,1016,2317,2207,110,2
2021,Southend-on-Sea 015,E02003293,5668,2307,1141,1166,20,20,243,75,168,3096,2953,143,2
2021,Southend-on-Sea 016,E02003294,3956,3248,2003,1245,13,13,59,25,34,636,547,89,0
2021,Southend-on-Sea 017,E02003295,3926,2737,1488,1249,15,15,610,430,180,563,507,56,1
2021,Thurrock 001,E02003296,2764,2449,1324,1125,5,5,28,20,8,282,242,40,0
2021,Thurrock 002,E02003297,2916,1986,1053,933,4,4,551,490,61,373,320,53,2
2021,Thurrock 003,E02003298,2833,2095,1070,1025,10,10,457,292,165,267,213,54,4
2021,Thurrock 004,E02003299,2456,1993,1024,969,4,4,129,119,10,330,276,54,0
2021,Thurrock 005,E02003300,3588,2624,1153,1471,36,36,259,105,154,669,602,67,0
2021,Thurrock 006,E02003301,4513,2921,1047,1874,29,29,998,804,194,561,496,65,4
2021,Thurrock 007,E02003302,4025,2076,710,1366,11,11,1458,1347,111,475,421,54,5
2021,Thurrock 008,E02003303,3540,2373,839,1534,32,32,755,654,101,378,328,50,2
2021,Thurrock 009,E02003304,3640,2364,1084,1280,12,12,973,897,76,289,254,35,2
2021,Thurrock 010,E02003305,2653,2125,1055,1070,10,10,281,250,31,237,191,46,0
2021,Thurrock 012,E02003307,3961,2211,1028,1183,5,5,1364,1268,96,378,330,48,3
2021,Thurrock 013,E02003308,2805,2017,823,1194,33,33,240,101,139,514,467,47,1
2021,Thurrock 014,E02003309,3000,2249,1057,1192,9,9,234,191,43,504,445,59,4
2021,Thurrock 016,E02003311,3442,1957,755,1202,27,27,298,206,92,1158,1072,86,2
2021,Thurrock 017,E02003312,3768,1469,408,1061,40,40,873,613,260,1380,1307,73,6
2021,Thurrock 018,E02003313,5216,2208,803,1405,22,22,1869,1623,246,1111,1032,79,6
2021,Medway 001,E02003314,2863,2240,1281,959,31,31,278,49,229,314,249,65,0
2021,Medway 002,E02003315,2225,1838,914,924,19,19,169,24,145,199,157,42,0
2021,Medway 003,E02003316,4667,3481,1528,1953,115,115,567,83,484,504,424,80,0
2021,Medway 004,E02003317,2757,2019,893,1126,48,48,370,40,330,319,278,41,1
2021,Medway 005,E02003318,2283,1975,1099,876,14,14,100,9,91,194,161,33,0
2021,Medway 006,E02003319,3298,1850,789,1061,37,37,368,41,327,1043,953,90,0
2021,Medway 007,E02003320,3792,1783,713,1070,136,136,666,235,431,1204,1040,164,3
2021,Medway 008,E02003321,2495,1422,683,739,26,26,738,119,619,309,256,53,0
2021,Medway 009,E02003322,3136,1236,537,699,129,129,422,267,155,1346,1268,78,3
2021,Medway 010,E02003323,2820,1524,634,890,82,82,624,280,344,589,539,50,1
2021,Medway 011,E02003324,3860,2532,954,1578,109,109,566,90,476,653,585,68,0
2021,Medway 012,E02003325,3009,1158,503,655,22,22,507,305,202,1317,1256,61,5
2021,Medway 013,E02003326,2961,1855,825,1030,23,23,220,143,77,862,788,74,1
2021,Medway 014,E02003327,3661,1552,664,888,77,77,858,94,764,1172,1068,104,2
2021,Medway 015,E02003328,4331,1433,589,844,116,116,1133,204,929,1643,1471,172,6
2021,Medway 016,E02003329,2645,1370,610,760,5,5,107,36,71,1163,1079,84,0
2021,Medway 017,E02003330,2732,1727,775,952,67,67,341,34,307,596,544,52,1
2021,Medway 018,E02003331,3669,2336,1132,1204,19,19,888,713,175,418,361,57,8
2021,Medway 019,E02003332,2310,1625,820,805,37,37,333,247,86,312,281,31,3
2021,Medway 020,E02003333,2788,1159,475,684,38,38,509,94,415,1076,1008,68,6
2021,Medway 021,E02003334,2311,1361,633,728,11,11,213,42,171,726,677,49,0
2021,Medway 022,E02003335,2700,1200,465,735,22,22,576,140,436,895,847,48,7
2021,Medway 023,E02003336,2634,2213,1260,953,24,24,157,111,46,237,196,41,3
2021,Medway 024,E02003337,2677,1819,888,931,36,36,451,59,392,370,314,56,1
2021,Medway 025,E02003338,3174,1945,972,973,29,29,453,240,213,744,679,65,3
2021,Medway 026,E02003339,2433,1834,971,863,30,30,269,32,237,299,263,36,1
2021,Medway 027,E02003340,3219,1904,880,1024,23,23,911,159,752,380,326,54,1
2021,Medway 028,E02003341,2664,2172,1031,1141,59,59,204,22,182,227,195,32,2
2021,Medway 029,E02003342,2574,2052,1135,917,7,7,197,156,41,316,273,43,2
2021,Medway 030,E02003343,2377,2139,1317,822,12,12,52,41,11,172,139,33,2
2021,Medway 031,E02003344,2700,1707,740,967,21,21,644,127,517,327,288,39,1
2021,Medway 032,E02003345,2451,2032,941,1091,19,19,49,11,38,350,314,36,1
2021,Medway 033,E02003346,2878,2214,1107,1107,80,80,275,53,222,309,258,51,0
2021,Medway 034,E02003347,2436,1856,658,1198,34,34,86,16,70,459,423,36,1
2021,Medway 035,E02003348,3191,2842,1634,1208,7,7,32,9,23,310,265,45,0
2021,Medway 036,E02003349,3068,2449,1297,1152,14,14,172,115,57,432,382,50,1
2021,Medway 037,E02003350,2514,1856,915,941,20,20,404,80,324,232,190,42,2
2021,Medway 038,E02003351,3167,2420,1129,1291,52,52,217,30,187,477,427,50,1
2021,Bracknell Forest 001,E02003352,2505,2115,1320,795,11,11,56,19,37,323,250,73,0
2021,Bracknell Forest 002,E02003353,4935,3702,1412,2290,181,181,385,100,285,666,576,90,1
2021,Bracknell Forest 003,E02003354,4129,3021,1234,1787,41,41,443,130,313,622,582,40,2
2021,Bracknell Forest 004,E02003355,2878,1393,562,831,62,62,943,353,590,473,434,39,7
2021,Bracknell Forest 005,E02003356,2853,2236,1093,1143,5,5,136,48,88,471,411,60,5
2021,Bracknell Forest 006,E02003357,4328,2248,825,1423,130,130,1142,361,781,804,738,66,4
2021,Bracknell Forest 007,E02003358,5033,2336,879,1457,129,129,1375,317,1058,1186,1110,76,7
2021,Bracknell Forest 008,E02003359,2798,1690,568,1122,35,35,462,191,271,606,562,44,5
2021,Bracknell Forest 009,E02003360,4332,2875,1087,1788,139,139,820,312,508,496,446,50,2
2021,Bracknell Forest 010,E02003361,3074,1938,782,1156,20,20,711,252,459,404,363,41,1
2021,Bracknell Forest 011,E02003362,2734,1782,817,965,8,8,581,215,366,363,323,40,0
2021,Bracknell Forest 012,E02003363,2672,2006,1108,898,72,72,133,32,101,460,368,92,1
2021,Bracknell Forest 013,E02003364,2713,2117,853,1264,26,26,283,73,210,286,254,32,1
2021,Bracknell Forest 014,E02003365,2745,2189,1006,1183,13,13,245,56,189,298,264,34,0
2021,Bracknell Forest 015,E02003366,2519,1891,940,951,7,7,178,51,127,443,276,167,0
2021,West Berkshire 001,E02003367,2474,1643,841,802,20,20,392,26,366,419,310,109,0
2021,West Berkshire 002,E02003368,2507,1535,871,664,10,10,453,46,407,508,355,153,1
2021,West Berkshire 003,E02003369,2560,1926,1095,831,19,19,185,10,175,430,336,94,0
2021,West Berkshire 004,E02003370,2723,2246,1243,1003,23,23,144,13,131,310,257,53,0
2021,West Berkshire 005,E02003371,2348,2157,1201,956,4,4,25,2,23,162,131,31,0
2021,West Berkshire 006,E02003372,3093,2419,1316,1103,9,9,335,28,307,329,296,33,1
2021,West Berkshire 007,E02003373,3041,2166,1094,1072,40,40,272,16,256,563,399,164,0
2021,West Berkshire 008,E02003374,2451,1750,807,943,18,18,328,19,309,355,321,34,0
2021,West Berkshire 009,E02003375,2693,1621,713,908,48,48,538,45,493,486,442,44,0
2021,West Berkshire 010,E02003376,2691,1619,978,641,21,21,423,33,390,628,568,60,0
2021,West Berkshire 011,E02003377,3972,2923,1632,1291,56,56,399,40,359,593,447,146,1
2021,West Berkshire 012,E02003378,3595,2112,1214,898,35,35,726,63,663,721,642,79,1
2021,West Berkshire 013,E02003379,2828,1635,740,895,64,64,547,54,493,582,540,42,0
2021,West Berkshire 014,E02003380,3362,2572,1186,1386,48,48,332,22,310,409,357,52,1
2021,West Berkshire 015,E02003381,2379,1689,839,850,26,26,291,26,265,373,218,155,0
2021,West Berkshire 016,E02003382,3205,1812,874,938,41,41,847,60,787,504,446,58,1
2021,West Berkshire 017,E02003383,2765,2114,989,1125,27,27,237,18,219,387,354,33,0
2021,West Berkshire 018,E02003384,2711,1831,1064,767,10,10,329,25,304,541,417,124,0
2021,West Berkshire 019,E02003385,5350,2546,1067,1479,271,271,928,78,850,1605,1487,118,0
2021,West Berkshire 020,E02003386,3660,2057,963,1094,33,33,902,93,809,668,605,63,0
2021,West Berkshire 021,E02003387,3752,2895,1559,1336,29,29,330,32,298,497,435,62,1
2021,West Berkshire 022,E02003388,2502,1775,926,849,26,26,339,36,303,362,307,55,0
2021,Reading 001,E02003389,3187,2604,1392,1212,45,45,140,47,93,398,346,52,0
2021,Reading 002,E02003390,2894,2610,1359,1251,9,9,46,17,29,229,208,21,0
2021,Reading 003,E02003391,3408,2623,1317,1306,11,11,282,192,90,489,443,46,3
2021,Reading 004,E02003392,3767,1944,856,1088,69,69,647,259,388,1103,1041,62,4
2021,Reading 005,E02003393,3280,2657,1378,1279,6,6,102,56,46,511,459,52,4
2021,Reading 006,E02003394,3204,1688,585,1103,65,65,826,542,284,615,558,57,10
2021,Reading 007,E02003395,4296,1677,648,1029,80,80,373,67,306,2165,2049,116,1
2021,Reading 008,E02003396,4072,2113,847,1266,74,74,440,105,335,1441,1358,83,4
2021,Reading 009,E02003397,3247,1933,961,972,11,11,828,689,139,460,417,43,15
2021,Reading 010,E02003398,4274,1472,546,926,61,61,669,335,334,2065,1948,117,7
2021,Reading 012,E02003400,3092,1318,647,671,16,16,107,26,81,1651,1595,56,0
2021,Reading 013,E02003401,3854,1783,839,944,38,38,733,464,269,1297,1231,66,3
2021,Reading 014,E02003402,4060,1486,609,877,33,33,444,242,202,2094,1982,112,3
2021,Reading 015,E02003403,3825,2167,1039,1128,40,40,1093,783,310,506,457,49,19
2021,Reading 016,E02003404,2279,1055,558,497,21,21,726,520,206,466,423,43,11
2021,Reading 017,E02003405,4909,1724,570,1154,109,109,1683,922,761,1378,1293,85,15
2021,Reading 018,E02003406,3047,1718,732,986,58,58,847,609,238,412,372,40,12
2021,Slough 001,E02003407,3709,1738,556,1182,62,62,1433,1125,308,464,425,39,12
2021,Slough 002,E02003408,3524,1822,866,956,14,14,457,267,190,1224,1144,80,7
2021,Slough 003,E02003409,3986,2093,864,1229,34,34,871,661,210,984,924,60,4
2021,Slough 004,E02003410,3400,1685,743,942,26,26,666,488,178,1009,912,97,14
2021,Slough 005,E02003411,3743,1775,732,1043,21,21,962,616,346,971,877,94,14
2021,Slough 006,E02003412,3619,2213,916,1297,28,28,491,327,164,885,824,61,2
2021,Slough 008,E02003414,4732,2368,774,1594,84,84,853,380,473,1427,1356,71,0
2021,Slough 009,E02003415,4259,1475,584,891,43,43,710,375,335,2024,1910,114,7
2021,Slough 010,E02003416,3310,2011,820,1191,26,26,375,223,152,898,846,52,0
2021,Slough 011,E02003417,4584,2002,791,1211,51,51,570,274,296,1957,1864,93,4
2021,Slough 012,E02003418,3374,1770,678,1092,31,31,914,793,121,653,616,37,6
2021,Slough 013,E02003419,3141,1549,612,937,40,40,882,436,446,665,612,53,5
2021,Slough 014,E02003420,2394,1106,420,686,39,39,369,66,303,879,841,38,1
2021,Windsor and Maidenhead 001,E02003421,2151,1739,948,791,8,8,84,7,77,319,273,46,1
2021,Windsor and Maidenhead 002,E02003422,4857,3685,2046,1639,23,23,404,25,379,743,560,183,2
2021,Windsor and Maidenhead 003,E02003423,2381,1407,650,757,21,21,660,42,618,291,263,28,2
2021,Windsor and Maidenhead 004,E02003424,3897,2833,1412,1421,31,31,101,6,95,932,857,75,0
2021,Windsor and Maidenhead 005,E02003425,5621,2581,1141,1440,88,88,1033,83,950,1912,1806,106,7
2021,Windsor and Maidenhead 006,E02003426,3771,2897,1427,1470,17,17,197,15,182,659,582,77,1
2021,Windsor and Maidenhead 007,E02003427,3037,1731,810,921,54,54,621,50,571,629,577,52,2
2021,Windsor and Maidenhead 008,E02003428,3563,2599,1329,1270,23,23,612,47,565,328,280,48,1
2021,Windsor and Maidenhead 009,E02003429,2959,2347,1236,1111,9,9,189,7,182,413,340,73,1
2021,Windsor and Maidenhead 010,E02003430,2590,1316,673,643,15,15,386,34,352,873,651,222,0
2021,Windsor and Maidenhead 011,E02003431,2795,1842,821,1021,11,11,418,72,346,523,458,65,1
2021,Windsor and Maidenhead 012,E02003432,3140,1765,811,954,4,4,401,34,367,969,863,106,1
2021,Windsor and Maidenhead 013,E02003433,2664,1815,1056,759,11,11,301,45,256,537,301,236,0
2021,Windsor and Maidenhead 014,E02003434,3773,2037,997,1040,42,42,1096,131,965,596,549,47,2
2021,Windsor and Maidenhead 015,E02003435,2930,1975,961,1014,2,2,166,19,147,787,648,139,0
2021,Windsor and Maidenhead 016,E02003436,3501,2593,1327,1266,6,6,255,19,236,645,436,209,2
2021,Windsor and Maidenhead 017,E02003437,2955,1997,1016,981,16,16,408,29,379,534,448,86,0
2021,Windsor and Maidenhead 018,E02003438,4353,3150,1733,1417,12,12,328,42,286,863,743,120,0
2021,Wokingham 001,E02003439,2321,1748,993,755,12,12,257,181,76,302,211,91,2
2021,Wokingham 002,E02003440,3786,2869,1471,1398,33,33,263,186,77,619,568,51,2
2021,Wokingham 003,E02003441,3017,2519,1409,1110,12,12,140,109,31,344,296,48,2
2021,Wokingham 004,E02003442,3334,2681,1123,1558,51,51,139,29,110,463,433,30,0
2021,Wokingham 005,E02003443,2782,1728,892,836,50,50,656,467,189,345,306,39,3
2021,Wokingham 006,E02003444,3280,2579,1283,1296,32,32,121,42,79,544,489,55,4
2021,Wokingham 007,E02003445,3423,2952,1463,1489,28,28,86,28,58,357,324,33,0
2021,Wokingham 008,E02003446,3130,2659,1418,1241,12,12,84,31,53,375,346,29,0
2021,Wokingham 009,E02003447,3949,2834,1146,1688,203,203,447,134,313,464,411,53,1
2021,Wokingham 010,E02003448,3138,2405,1147,1258,155,155,174,76,98,404,339,65,0
2021,Wokingham 011,E02003449,3148,2295,1007,1288,21,21,64,9,55,767,724,43,1
2021,Wokingham 012,E02003450,5015,3538,1382,2156,171,171,518,277,241,787,716,71,1
2021,Wokingham 013,E02003451,4536,2590,1412,1178,82,82,863,552,311,999,913,86,2
2021,Wokingham 014,E02003452,3694,2847,1164,1683,144,144,304,82,222,399,365,34,0
2021,Wokingham 015,E02003453,2654,2369,1175,1194,34,34,43,13,30,208,187,21,0
2021,Wokingham 016,E02003454,3569,2658,1315,1343,29,29,272,76,196,606,557,49,4
2021,Wokingham 017,E02003455,4217,3140,1142,1998,253,253,354,189,165,468,405,63,2
2021,Wokingham 018,E02003456,3172,2037,836,1201,92,92,330,206,124,709,551,158,4
2021,Wokingham 019,E02003457,3788,3361,1733,1628,7,7,141,102,39,278,250,28,1
2021,Wokingham 020,E02003458,3217,2788,1442,1346,5,5,75,56,19,348,275,73,1
2021,Milton Keynes 001,E02003459,3881,2799,1605,1194,35,35,278,176,102,768,693,75,1
2021,Milton Keynes 002,E02003460,4840,3512,1674,1838,147,147,608,264,344,571,483,88,2
2021,Milton Keynes 003,E02003461,3020,2284,1258,1026,38,38,257,183,74,440,390,50,1
2021,Milton Keynes 004,E02003462,3495,2465,1200,1265,73,73,224,126,98,732,659,73,1
2021,Milton Keynes 005,E02003463,2744,1738,916,822,148,148,425,317,108,430,398,32,3
2021,Milton Keynes 006,E02003464,2677,1312,580,732,89,89,779,588,191,489,437,52,8
2021,Milton Keynes 007,E02003465,2732,1697,927,770,331,331,273,156,117,431,387,44,0
2021,Milton Keynes 008,E02003466,3094,1774,714,1060,47,47,384,278,106,887,822,65,2
2021,Milton Keynes 009,E02003467,2572,1125,557,568,30,30,782,441,341,631,570,61,4
2021,Milton Keynes 010,E02003468,3771,2438,1267,1171,182,182,381,244,137,765,690,75,5
2021,Milton Keynes 011,E02003469,2417,1666,902,764,126,126,180,147,33,443,413,30,2
2021,Milton Keynes 012,E02003470,2237,701,293,408,54,54,1102,833,269,367,329,38,13
2021,Milton Keynes 013,E02003471,2581,1168,586,582,184,184,665,379,286,561,507,54,3
2021,Milton Keynes 014,E02003472,4461,927,395,532,258,258,1141,658,483,2122,2037,85,13
2021,Milton Keynes 015,E02003473,2340,1294,636,658,303,303,100,71,29,643,597,46,0
2021,Milton Keynes 016,E02003474,3416,1874,890,984,153,153,617,195,422,766,710,56,6
2021,Milton Keynes 018,E02003476,3177,868,375,493,84,84,1229,896,333,992,901,91,4
2021,Milton Keynes 020,E02003478,2715,1399,634,765,336,336,368,133,235,609,555,54,3
2021,Milton Keynes 021,E02003479,2868,854,383,471,213,213,908,353,555,885,812,73,8
2021,Milton Keynes 022,E02003480,3438,1593,672,921,415,415,726,46,680,700,659,41,4
2021,Milton Keynes 023,E02003481,3358,1033,479,554,123,123,1554,1108,446,638,572,66,10
2021,Milton Keynes 024,E02003482,3610,2590,1141,1449,160,160,323,138,185,534,477,57,3
2021,Milton Keynes 025,E02003483,4020,2292,676,1616,246,246,659,72,587,823,781,42,0
2021,Milton Keynes 026,E02003484,2916,1398,645,753,350,350,558,104,454,609,558,51,1
2021,Milton Keynes 027,E02003485,3223,2003,1014,989,53,53,713,608,105,444,393,51,10
2021,Milton Keynes 028,E02003486,3800,2250,729,1521,372,372,428,75,353,748,699,49,2
2021,Milton Keynes 029,E02003487,2952,1969,1047,922,45,45,546,514,32,383,345,38,9
2021,Milton Keynes 030,E02003488,3342,2044,1032,1012,65,65,462,347,115,763,689,74,8
2021,Milton Keynes 031,E02003489,3121,2087,1074,1013,127,127,376,228,148,528,475,53,3
2021,Milton Keynes 032,E02003490,3991,1859,533,1326,217,217,1279,1035,244,618,574,44,18
2021,Brighton and Hove 001,E02003491,3057,2390,1174,1216,12,12,335,284,51,318,269,49,2
2021,Brighton and Hove 002,E02003492,2078,819,441,378,6,6,843,721,122,393,358,35,17
2021,Brighton and Hove 003,E02003493,3371,2541,1374,1167,15,15,209,116,93,602,537,65,4
2021,Brighton and Hove 004,E02003494,2642,2095,1099,996,10,10,201,148,53,335,297,38,1
2021,Brighton and Hove 005,E02003495,2943,2042,983,1059,22,22,479,201,278,396,345,51,4
2021,Brighton and Hove 006,E02003496,3132,1922,1033,889,16,16,781,708,73,398,352,46,15
2021,Brighton and Hove 007,E02003497,2879,2319,1191,1128,22,22,75,38,37,463,415,48,0
2021,Brighton and Hove 008,E02003498,3437,1151,549,602,27,27,1484,1084,400,745,679,66,30
2021,Brighton and Hove 009,E02003499,2761,991,517,474,38,38,1171,725,446,543,506,37,18
2021,Brighton and Hove 010,E02003500,2952,2259,959,1300,9,9,87,42,45,597,551,46,0
2021,Brighton and Hove 011,E02003501,3664,2363,1164,1199,23,23,119,49,70,1158,1100,58,1
2021,Brighton and Hove 012,E02003502,3229,1982,869,1113,26,26,675,451,224,539,477,62,7
2021,Brighton and Hove 013,E02003503,3453,2293,1109,1184,16,16,675,429,246,462,406,56,7
2021,Brighton and Hove 014,E02003504,3903,2070,875,1195,56,56,303,83,220,1472,1372,100,2
2021,Brighton and Hove 015,E02003505,3835,1567,619,948,37,37,355,181,174,1872,1770,102,4
2021,Brighton and Hove 016,E02003506,2965,1885,681,1204,38,38,214,85,129,824,779,45,4
2021,Brighton and Hove 017,E02003507,3914,2767,1567,1200,25,25,630,439,191,484,419,65,8
2021,Brighton and Hove 018,E02003508,3405,1937,832,1105,21,21,161,84,77,1285,1198,87,1
2021,Brighton and Hove 019,E02003509,4599,1789,739,1050,26,26,513,340,173,2261,2168,93,10
2021,Brighton and Hove 020,E02003510,4137,2163,1090,1073,56,56,208,54,154,1710,1605,105,0
2021,Brighton and Hove 021,E02003511,3528,2250,963,1287,22,22,331,192,139,920,855,65,5
2021,Brighton and Hove 022,E02003512,3726,1784,730,1054,19,19,478,223,255,1438,1348,90,7
2021,Brighton and Hove 023,E02003513,2819,1637,817,820,12,12,434,302,132,730,679,51,6
2021,Brighton and Hove 024,E02003514,4731,1670,709,961,8,8,337,91,246,2711,2601,110,5
2021,Brighton and Hove 025,E02003515,3703,935,454,481,53,53,2299,1819,480,395,350,45,21
2021,Brighton and Hove 026,E02003516,4702,1657,721,936,10,10,170,66,104,2865,2737,128,0
2021,Brighton and Hove 027,E02003517,5400,1616,839,777,158,158,773,293,480,2843,2710,133,10
2021,Brighton and Hove 028,E02003518,4131,1901,1003,898,55,55,281,58,223,1893,1783,110,1
2021,Brighton and Hove 029,E02003519,4796,1499,658,841,11,11,321,64,257,2964,2840,124,1
2021,Brighton and Hove 030,E02003520,4691,1288,646,642,56,56,1365,1061,304,1951,1835,116,31
2021,Brighton and Hove 031,E02003521,4341,1602,820,782,20,20,929,611,318,1775,1666,109,15
2021,Brighton and Hove 032,E02003522,3824,1595,948,647,27,27,615,465,150,1571,1476,95,16
2021,Brighton and Hove 033,E02003523,4655,3636,2272,1364,46,46,200,80,120,771,685,86,2
2021,Portsmouth 001,E02003524,3062,1509,653,856,28,28,1159,975,184,350,302,48,16
2021,Portsmouth 002,E02003525,2586,1049,504,545,19,19,1018,710,308,487,422,65,13
2021,Portsmouth 003,E02003526,2804,2337,1443,894,22,22,167,31,136,278,236,42,0
2021,Portsmouth 004,E02003527,2726,1711,842,869,20,20,424,265,159,568,444,124,3
2021,Portsmouth 006,E02003529,3246,2470,1143,1327,27,27,276,162,114,469,402,67,4
2021,Portsmouth 007,E02003530,3319,1824,856,968,46,46,766,302,464,674,450,224,9
2021,Portsmouth 008,E02003531,3315,2580,1352,1228,17,17,115,23,92,601,524,77,2
2021,Portsmouth 009,E02003532,3257,2010,886,1124,8,8,187,42,145,1045,969,76,7
2021,Portsmouth 010,E02003533,2487,1302,579,723,12,12,393,264,129,772,698,74,8
2021,Portsmouth 011,E02003534,3488,2305,1024,1281,24,24,117,45,72,1042,951,91,0
2021,Portsmouth 012,E02003535,3825,2191,853,1338,26,26,240,53,187,1366,1262,104,2
2021,Portsmouth 013,E02003536,3331,664,324,340,31,31,2134,1832,302,481,447,34,21
2021,Portsmouth 014,E02003537,4163,2928,1389,1539,54,54,536,267,269,640,561,79,5
2021,Portsmouth 015,E02003538,4348,1946,783,1163,43,43,614,259,355,1734,1633,101,11
2021,Portsmouth 017,E02003540,4092,2707,1358,1349,78,78,510,210,300,795,704,91,2
2021,Portsmouth 018,E02003541,4227,867,498,369,31,31,1935,1535,400,1363,1300,63,31
2021,Portsmouth 019,E02003542,3562,1925,869,1056,17,17,199,37,162,1420,1328,92,1
2021,Portsmouth 020,E02003543,3521,1419,663,756,29,29,284,64,220,1788,1668,120,1
2021,Portsmouth 021,E02003544,2849,1666,700,966,24,24,211,62,149,948,860,88,0
2021,Portsmouth 022,E02003545,3495,1279,645,634,13,13,498,122,376,1698,1586,112,7
2021,Portsmouth 023,E02003546,3718,2175,1228,947,30,30,248,76,172,1262,1081,181,3
2021,Portsmouth 024,E02003547,4387,1966,1259,707,24,24,373,99,274,2022,1808,214,2
2021,Portsmouth 025,E02003548,2779,1474,730,744,34,34,90,23,67,1181,1119,62,0
2021,Southampton 001,E02003549,2657,1696,870,826,11,11,264,211,53,681,627,54,5
2021,Southampton 002,E02003550,3291,2055,977,1078,22,22,689,511,178,524,482,42,1
2021,Southampton 003,E02003551,2306,955,483,472,31,31,887,275,612,433,389,44,0
2021,Southampton 004,E02003552,2644,1136,499,637,8,8,1135,930,205,355,325,30,10
2021,Southampton 005,E02003553,2391,782,375,407,14,14,551,447,104,1042,1002,40,2
2021,Southampton 006,E02003554,2641,1542,865,677,14,14,364,281,83,717,668,49,4
2021,Southampton 007,E02003555,3613,1934,810,1124,55,55,990,735,255,625,570,55,9
2021,Southampton 008,E02003556,2382,1719,876,843,14,14,209,127,82,440,403,37,0
2021,Southampton 009,E02003557,2756,1364,811,553,10,10,202,55,147,1179,1118,61,1
2021,Southampton 010,E02003558,3061,1114,508,606,45,45,895,661,234,1002,955,47,5
2021,Southampton 011,E02003559,3044,2256,1175,1081,13,13,187,71,116,588,536,52,0
2021,Southampton 012,E02003560,3064,1169,516,653,20,20,1488,1338,150,381,352,29,6
2021,Southampton 013,E02003561,3202,1083,558,525,20,20,582,233,349,1510,1449,61,7
2021,Southampton 014,E02003562,3716,2143,984,1159,40,40,333,105,228,1200,1116,84,0
2021,Southampton 015,E02003563,3559,1699,839,860,44,44,807,532,275,1005,942,63,4
2021,Southampton 016,E02003564,3431,2116,1039,1077,26,26,715,552,163,568,516,52,6
2021,Southampton 017,E02003565,2710,671,300,371,26,26,355,58,297,1658,1586,72,0
2021,Southampton 018,E02003566,2726,1608,774,834,44,44,743,525,218,320,283,37,11
2021,Southampton 019,E02003567,3066,1702,774,928,23,23,784,644,140,552,506,46,5
2021,Southampton 020,E02003568,3771,1596,696,900,19,19,171,31,140,1984,1911,73,1
2021,Southampton 021,E02003569,3730,1462,664,798,33,33,566,171,395,1667,1583,84,2
2021,Southampton 022,E02003570,4076,912,367,545,27,27,1011,555,456,2120,2007,113,6
2021,Southampton 023,E02003571,3215,744,342,402,54,54,680,254,426,1735,1665,70,2
2021,Southampton 024,E02003572,2498,1838,868,970,9,9,204,157,47,441,409,32,6
2021,Southampton 025,E02003573,3323,1623,839,784,20,20,1380,1180,200,289,254,35,11
2021,Southampton 026,E02003574,3428,2413,1215,1198,23,23,397,271,126,595,534,61,0
2021,Southampton 027,E02003575,2838,1038,486,552,33,33,1417,1233,184,343,307,36,7
2021,Southampton 028,E02003576,3455,1856,729,1127,34,34,732,459,273,831,762,69,2
2021,Southampton 030,E02003578,2743,1899,883,1016,22,22,318,186,132,503,453,50,1
2021,Southampton 031,E02003579,4277,2295,989,1306,175,175,602,143,459,1204,1124,80,1
2021,Southampton 032,E02003580,2616,943,432,511,16,16,1312,1141,171,334,304,30,11
2021,Isle of Wight 001,E02003581,3671,2193,1191,1002,23,23,324,30,294,1129,1021,108,2
2021,Isle of Wight 002,E02003582,3741,2966,1850,1116,17,17,194,12,182,564,468,96,0
2021,Isle of Wight 003,E02003583,3523,2265,1405,860,57,57,555,48,507,646,579,67,0
2021,Isle of Wight 004,E02003584,3279,1517,939,578,8,8,271,32,239,1483,1385,98,0
2021,Isle of Wight 005,E02003585,3099,2480,1713,767,50,50,150,18,132,419,346,73,0
2021,Isle of Wight 006,E02003586,3403,2418,1492,926,18,18,371,46,325,596,510,86,0
2021,Isle of Wight 007,E02003587,3840,2219,1316,903,17,17,725,83,642,878,801,77,1
2021,Isle of Wight 008,E02003588,3625,2194,1169,1025,75,75,774,79,695,580,507,73,2
2021,Isle of Wight 009,E02003589,3467,1770,940,830,18,18,489,47,442,1190,1078,112,0
2021,Isle of Wight 010,E02003590,3558,2873,2194,679,13,13,175,12,163,497,395,102,0
2021,Isle of Wight 011,E02003591,4025,2871,1694,1177,40,40,430,41,389,682,574,108,2
2021,Isle of Wight 012,E02003592,4774,3418,2595,823,34,34,535,41,494,787,672,115,0
2021,Isle of Wight 013,E02003593,2402,1951,1365,586,17,17,125,12,113,309,240,69,0
2021,Isle of Wight 014,E02003594,4236,2699,1776,923,65,65,461,57,404,1009,915,94,2
2021,Isle of Wight 015,E02003595,3716,3044,2164,880,17,17,229,22,207,426,335,91,0
2021,Isle of Wight 016,E02003596,4212,2578,1836,742,12,12,515,44,471,1107,999,108,0
2021,Isle of Wight 017,E02003597,2591,1982,1353,629,15,15,261,18,243,333,264,69,0
2021,Isle of Wight 018,E02003598,3616,2386,1743,643,13,13,473,37,436,744,642,102,0
2021,Central Bedfordshire 001,E02003599,2316,1513,674,839,44,44,478,53,425,281,259,22,0
2021,Central Bedfordshire 002,E02003600,2702,1830,930,900,25,25,450,60,390,397,351,46,0
2021,Central Bedfordshire 003,E02003601,3494,2529,1297,1232,69,69,424,54,370,470,403,67,2
2021,Central Bedfordshire 004,E02003602,2716,1892,1069,823,33,33,415,33,382,376,314,62,0
2021,Central Bedfordshire 005,E02003603,4967,3178,1466,1712,106,106,759,89,670,922,837,85,2
2021,Central Bedfordshire 006,E02003604,4475,3243,1271,1972,118,118,621,67,554,491,443,48,2
2021,Central Bedfordshire 007,E02003605,3828,2730,1247,1483,126,126,430,33,397,541,426,115,1
2021,Central Bedfordshire 008,E02003606,3836,2919,1470,1449,81,81,512,40,472,320,271,49,4
2021,Central Bedfordshire 009,E02003607,4512,3129,1284,1845,127,127,572,42,530,683,597,86,1
2021,Central Bedfordshire 010,E02003608,5134,3630,1683,1947,122,122,815,81,734,563,480,83,4
2021,Central Bedfordshire 011,E02003609,4669,3135,1483,1652,110,110,731,66,665,692,441,251,1
2021,Central Bedfordshire 012,E02003610,3747,2868,1355,1513,86,86,358,35,323,435,369,66,0
2021,Central Bedfordshire 013,E02003611,4014,3050,1544,1506,94,94,427,26,401,442,301,141,1
2021,Central Bedfordshire 014,E02003612,4942,3748,1612,2136,100,100,542,54,488,551,486,65,1
2021,Central Bedfordshire 015,E02003613,2439,1590,795,795,9,9,479,48,431,360,323,37,1
2021,Central Bedfordshire 016,E02003614,3445,2714,1239,1475,22,22,155,20,135,553,502,51,1
2021,Central Bedfordshire 017,E02003615,4158,3310,1691,1619,91,91,389,28,361,368,310,58,0
2021,Bedford 001,E02003616,2345,1851,1097,754,21,21,171,15,156,300,229,71,2
2021,Bedford 002,E02003617,3823,2937,1713,1224,41,41,345,39,306,499,433,66,1
2021,Bedford 003,E02003618,3622,2776,1520,1256,34,34,353,45,308,459,389,70,0
2021,Bedford 004,E02003619,4716,3533,1835,1698,110,110,531,65,466,542,458,84,0
2021,Bedford 005,E02003620,3504,2626,1568,1058,14,14,521,58,463,342,291,51,1
2021,Bedford 006,E02003621,3305,2708,1670,1038,11,11,290,29,261,295,249,46,1
2021,Bedford 007,E02003622,3805,2066,1105,961,32,32,1200,205,995,507,451,56,0
2021,Bedford 008,E02003623,5083,3955,1776,2179,182,182,389,34,355,556,487,69,1
2021,Bedford 009,E02003624,2462,1271,710,561,22,22,256,37,219,910,847,63,3
2021,Bedford 010,E02003625,4205,1611,813,798,32,32,932,147,785,1625,1516,109,5
2021,Bedford 011,E02003626,2359,1624,910,714,15,15,253,28,225,467,433,34,0
2021,Bedford 012,E02003627,5037,1952,965,987,122,122,871,142,729,2085,1964,121,7
2021,Bedford 013,E02003628,3056,1557,737,820,36,36,528,94,434,935,849,86,0
2021,Bedford 014,E02003629,4303,1975,895,1080,38,38,1307,254,1053,979,869,110,4
2021,Bedford 015,E02003630,4300,1740,756,984,61,61,1086,195,891,1413,1317,96,0
2021,Bedford 016,E02003631,2265,1321,729,592,21,21,573,38,535,345,317,28,5
2021,Bedford 017,E02003632,2528,1603,822,781,37,37,309,43,266,578,536,42,1
2021,Bedford 018,E02003633,4030,2615,1141,1474,107,107,723,112,611,584,516,68,1
2021,Bedford 020,E02003635,3949,2900,1033,1867,187,187,612,84,528,249,191,58,1
2021,Central Bedfordshire 018,E02003636,3011,2336,1220,1116,17,17,214,135,79,440,393,47,4
2021,Central Bedfordshire 019,E02003637,4411,3437,1700,1737,73,73,389,321,68,508,436,72,4
2021,Central Bedfordshire 020,E02003638,3059,2501,1345,1156,14,14,255,217,38,287,246,41,2
2021,Central Bedfordshire 021,E02003639,4355,2454,1127,1327,33,33,948,679,269,910,817,93,10
2021,Central Bedfordshire 022,E02003640,2690,1923,992,931,17,17,231,145,86,517,486,31,2
2021,Central Bedfordshire 023,E02003641,2224,1820,949,871,9,9,86,42,44,309,274,35,0
2021,Central Bedfordshire 025,E02003642,3544,1923,698,1225,46,46,1009,843,166,558,487,71,8
2021,Central Bedfordshire 024,E02003643,5478,3871,1318,2553,170,170,652,149,503,780,689,91,5
2021,Central Bedfordshire 026,E02003644,4004,2613,1060,1553,76,76,766,255,511,546,487,59,3
2021,Central Bedfordshire 027,E02003645,2689,2175,1134,1041,19,19,99,17,82,396,345,51,0
2021,Central Bedfordshire 028,E02003646,4162,2818,1199,1619,75,75,781,567,214,481,433,48,7
2021,Central Bedfordshire 029,E02003647,4622,2760,1169,1591,107,107,674,391,283,1076,991,85,5
2021,Central Bedfordshire 030,E02003648,2279,1332,646,686,18,18,672,511,161,254,223,31,3
2021,Central Bedfordshire 031,E02003649,2821,2201,1226,975,32,32,116,63,53,471,428,43,1
2021,Central Bedfordshire 032,E02003650,3029,2383,1411,972,14,14,341,296,45,289,231,58,2
2021,Central Bedfordshire 033,E02003651,2988,2367,1313,1054,32,32,289,158,131,298,249,49,2
2021,Buckinghamshire 001,E02003652,3924,2830,1439,1391,124,124,390,90,300,580,498,82,0
2021,Buckinghamshire 002,E02003653,2946,1791,1003,788,30,30,473,116,357,649,582,67,3
2021,Buckinghamshire 003,E02003654,2370,1930,1023,907,21,21,213,87,126,205,169,36,1
2021,Buckinghamshire 004,E02003655,4173,3120,1548,1572,54,54,472,114,358,524,439,85,3
2021,Buckinghamshire 005,E02003656,2923,2045,1155,890,19,19,379,104,275,478,428,50,2
2021,Buckinghamshire 006,E02003657,2957,2206,1114,1092,36,36,343,87,256,372,295,77,0
2021,Buckinghamshire 007,E02003658,4009,3131,1395,1736,60,60,487,107,380,330,244,86,1
2021,Buckinghamshire 009,E02003659,3813,2585,1173,1412,92,92,582,76,506,551,447,104,3
2021,Buckinghamshire 008,E02003660,4370,3468,1754,1714,42,42,450,127,323,409,337,72,1
2021,Buckinghamshire 010,E02003661,2246,1745,925,820,19,19,159,52,107,322,254,68,1
2021,Buckinghamshire 012,E02003662,2625,1579,688,891,22,22,469,116,353,552,513,39,3
2021,Buckinghamshire 011,E02003663,5025,3043,650,2393,242,242,1156,276,880,581,533,48,3
2021,Buckinghamshire 013,E02003664,3182,1814,686,1128,77,77,712,214,498,573,513,60,6
2021,Buckinghamshire 014,E02003665,2423,1625,760,865,82,82,320,52,268,394,356,38,2
2021,Buckinghamshire 015,E02003666,3500,1585,731,854,120,120,613,114,499,1180,1097,83,2
2021,Buckinghamshire 016,E02003667,3991,2589,925,1664,36,36,340,93,247,1025,945,80,1
2021,Buckinghamshire 018,E02003668,3496,2924,1671,1253,19,19,142,25,117,411,328,83,0
2021,Buckinghamshire 017,E02003669,2693,1159,437,722,53,53,999,383,616,477,434,43,5
2021,Buckinghamshire 019,E02003670,3818,2587,1213,1374,57,57,453,94,359,718,636,82,3
2021,Buckinghamshire 020,E02003671,2461,1478,618,860,29,29,532,194,338,417,381,36,5
2021,Buckinghamshire 021,E02003672,4911,3858,1973,1885,86,86,515,104,411,450,362,88,2
2021,Buckinghamshire 022,E02003673,3958,3033,1687,1346,66,66,413,94,319,443,378,65,3
2021,Buckinghamshire 023,E02003674,2280,1764,975,789,8,8,286,80,206,222,181,41,0
2021,Buckinghamshire 024,E02003675,3763,2463,1271,1192,26,26,484,109,375,787,460,327,3
2021,Buckinghamshire 029,E02003676,3253,2685,1600,1085,7,7,199,23,176,362,270,92,0
2021,Buckinghamshire 027,E02003677,3985,2450,1211,1239,38,38,1105,205,900,389,339,50,3
2021,Buckinghamshire 028,E02003678,2302,1818,897,921,9,9,189,33,156,286,255,31,0
2021,Buckinghamshire 030,E02003679,3104,1714,824,890,20,20,705,100,605,662,612,50,3
2021,Buckinghamshire 031,E02003680,4097,3244,1815,1429,10,10,405,51,354,436,366,70,2
2021,Buckinghamshire 032,E02003681,4217,3016,1668,1348,10,10,539,65,474,651,591,60,1
2021,Buckinghamshire 034,E02003682,3092,2265,1157,1108,32,32,322,39,283,473,418,55,0
2021,Buckinghamshire 035,E02003683,2803,1965,996,969,75,75,459,62,397,304,274,30,0
2021,Buckinghamshire 047,E02003685,3178,2589,1424,1165,21,21,267,29,238,301,248,53,0
2021,Buckinghamshire 050,E02003686,2998,2475,1347,1128,20,20,168,18,150,334,281,53,1
2021,Buckinghamshire 054,E02003687,2217,1712,881,831,2,2,299,54,245,204,162,42,0
2021,Buckinghamshire 053,E02003688,4880,3317,1793,1524,21,21,673,60,613,869,773,96,0
2021,Buckinghamshire 058,E02003689,3363,2597,1355,1242,8,8,153,16,137,605,537,68,0
2021,Buckinghamshire 059,E02003690,3222,2113,1127,986,67,67,550,58,492,492,438,54,0
2021,Buckinghamshire 063,E02003691,2818,2083,1100,983,50,50,317,25,292,368,308,60,0
2021,Buckinghamshire 064,E02003692,3426,2587,1405,1182,48,48,306,32,274,485,418,67,0
2021,Buckinghamshire 065,E02003693,2959,2275,1264,1011,36,36,173,27,146,471,403,68,4
2021,Buckinghamshire 066,E02003694,3476,2135,1058,1077,29,29,754,71,683,557,500,57,1
2021,Buckinghamshire 067,E02003695,4129,2859,1311,1548,105,105,565,64,501,600,517,83,0
2021,Buckinghamshire 026,E02003696,3817,2768,1676,1092,30,30,564,118,446,452,395,57,3
2021,Buckinghamshire 025,E02003697,2553,1989,1095,894,36,36,165,29,136,363,193,170,0
2021,Buckinghamshire 033,E02003698,3318,2896,1623,1273,18,18,73,10,63,330,160,170,1
2021,Buckinghamshire 037,E02003699,2386,1812,930,882,15,15,260,40,220,299,259,40,0
2021,Buckinghamshire 038,E02003701,4608,3159,1496,1663,101,101,708,139,569,635,565,70,5
2021,Buckinghamshire 040,E02003702,3257,2404,1321,1083,22,22,207,27,180,623,442,181,1
2021,Buckinghamshire 041,E02003703,3503,2128,930,1198,42,42,305,42,263,1028,949,79,0
2021,Buckinghamshire 045,E02003704,2331,1971,1004,967,8,8,111,22,89,240,201,39,1
2021,Buckinghamshire 042,E02003705,2495,1419,574,845,15,15,380,82,298,678,627,51,3
2021,Buckinghamshire 043,E02003706,2666,1497,623,874,91,91,680,172,508,396,358,38,2
2021,Buckinghamshire 044,E02003707,2558,1534,586,948,43,43,394,73,321,585,536,49,2
2021,Buckinghamshire 046,E02003708,3219,1530,657,873,28,28,575,144,431,1083,989,94,3
2021,Buckinghamshire 048,E02003709,2264,1200,467,733,42,42,717,171,546,298,263,35,7
2021,Buckinghamshire 049,E02003710,4434,2511,1039,1472,44,44,408,71,337,1469,1348,121,2
2021,Buckinghamshire 051,E02003711,4261,2358,861,1497,84,84,740,113,627,1078,1003,75,1
2021,Buckinghamshire 052,E02003712,3278,2187,1089,1098,53,53,657,162,495,377,325,52,4
2021,Buckinghamshire 055,E02003713,2377,2006,1155,851,7,7,187,51,136,176,142,34,1
2021,Buckinghamshire 056,E02003714,2879,2049,934,1115,28,28,341,86,255,459,399,60,2
2021,Buckinghamshire 057,E02003715,2579,2105,1241,864,5,5,111,11,100,358,181,177,0
2021,Buckinghamshire 060,E02003716,2611,1875,1047,828,6,6,244,52,192,486,422,64,0
2021,Buckinghamshire 062,E02003717,3869,2788,1552,1236,20,20,456,106,350,603,531,72,2
2021,Buckinghamshire 061,E02003718,2381,1626,838,788,13,13,274,64,210,465,412,53,3
2021,Cambridge 001,E02003719,4010,1483,750,733,93,93,1441,1191,250,980,890,90,13
2021,Cambridge 002,E02003720,3904,1848,1040,808,25,25,1033,911,122,981,904,77,17
2021,Cambridge 003,E02003721,4084,1499,845,654,79,79,1425,476,949,1077,1010,67,4
2021,Cambridge 004,E02003722,3775,1966,1238,728,34,34,450,130,320,1320,1239,81,5
2021,Cambridge 005,E02003723,2932,1272,795,477,27,27,421,116,305,1208,872,336,4
2021,Cambridge 006,E02003724,4234,1709,865,844,36,36,1356,1028,328,1122,1052,70,11
2021,Cambridge 007,E02003725,3561,1522,1036,486,33,33,442,142,300,1563,1173,390,1
2021,Cambridge 008,E02003726,3385,1419,819,600,30,30,501,244,257,1433,1334,99,2
2021,Cambridge 009,E02003727,4042,1788,870,918,54,54,563,353,210,1635,1548,87,2
2021,Cambridge 010,E02003728,4080,1801,998,803,31,31,865,642,223,1370,1281,89,13
2021,Cambridge 011,E02003729,3747,2113,1104,1009,26,26,846,639,207,757,691,66,5
2021,Cambridge 013,E02003731,4010,2096,1242,854,49,49,897,526,371,966,849,117,2
2021,East Cambridgeshire 001,E02003732,4100,2569,1171,1398,68,68,741,94,647,722,638,84,0
2021,East Cambridgeshire 002,E02003733,3511,2738,1431,1307,29,29,381,39,342,363,281,82,0
2021,East Cambridgeshire 003,E02003734,5205,3309,1742,1567,104,104,830,123,707,959,876,83,3
2021,East Cambridgeshire 004,E02003735,3762,2397,1297,1100,50,50,456,44,412,859,763,96,0
2021,East Cambridgeshire 005,E02003736,4303,3273,1855,1418,47,47,499,71,428,481,401,80,3
2021,East Cambridgeshire 006,E02003737,5604,3442,1660,1782,129,129,896,137,759,1135,1005,130,2
2021,East Cambridgeshire 007,E02003738,2703,1899,1036,863,24,24,370,46,324,408,329,79,2
2021,East Cambridgeshire 008,E02003739,2762,2106,1171,935,28,28,319,42,277,309,263,46,0
2021,East Cambridgeshire 009,E02003740,2520,1751,1028,723,44,44,386,50,336,339,262,77,0
2021,Fenland 001,E02003742,3001,2345,1502,843,18,18,257,50,207,380,325,55,1
2021,Fenland 002,E02003743,4487,2202,1230,972,16,16,942,260,682,1323,1224,99,4
2021,Fenland 003,E02003744,5992,3223,1933,1290,26,26,1091,242,849,1648,1508,140,4
2021,Fenland 004,E02003745,4448,3311,1920,1391,11,11,525,154,371,600,487,113,1
2021,Fenland 005,E02003746,3105,2253,1255,998,23,23,219,30,189,608,530,78,2
2021,Fenland 006,E02003747,5533,3854,2008,1846,45,45,637,116,521,996,868,128,1
2021,Fenland 007,E02003748,3553,2102,1274,828,13,13,572,80,492,865,789,76,1
2021,Fenland 008,E02003749,2613,2063,1087,976,6,6,144,36,108,400,344,56,0
2021,Fenland 009,E02003750,3331,2335,1437,898,25,25,374,55,319,593,532,61,4
2021,Fenland 010,E02003751,3145,2450,1340,1110,13,13,255,45,210,427,338,89,0
2021,Fenland 011,E02003752,4881,3314,1646,1668,41,41,565,106,459,960,846,114,1
2021,Huntingdonshire 001,E02003753,4636,3365,1651,1714,47,47,568,122,446,655,570,85,1
2021,Huntingdonshire 002,E02003754,2444,1810,1004,806,5,5,248,40,208,381,316,65,0
2021,Huntingdonshire 003,E02003755,3820,2530,1333,1197,44,44,552,108,444,693,594,99,1
2021,Huntingdonshire 004,E02003756,3044,2240,1151,1089,55,55,324,62,262,425,366,59,0
2021,Huntingdonshire 005,E02003757,2952,2180,1165,1015,40,40,395,69,326,337,280,57,0
2021,Huntingdonshire 006,E02003758,3980,2876,1514,1362,31,31,328,60,268,745,490,255,0
2021,Huntingdonshire 007,E02003759,2487,2091,1177,914,13,13,150,37,113,232,182,50,1
2021,Huntingdonshire 008,E02003760,3408,1525,588,937,54,54,1226,299,927,596,550,46,7
2021,Huntingdonshire 009,E02003761,2465,1891,1072,819,8,8,261,61,200,304,276,28,1
2021,Huntingdonshire 010,E02003762,4790,3381,1608,1773,112,112,553,105,448,742,531,211,2
2021,Huntingdonshire 011,E02003763,4175,2982,1570,1412,50,50,336,54,282,807,741,66,0
2021,Huntingdonshire 012,E02003764,4646,2434,1108,1326,120,120,614,95,519,1478,1360,118,0
2021,Huntingdonshire 013,E02003765,3345,2049,1209,840,33,33,459,55,404,803,719,84,1
2021,Huntingdonshire 014,E02003766,3464,2176,1029,1147,79,79,614,82,532,595,544,51,0
2021,Huntingdonshire 015,E02003767,2664,2126,1186,940,13,13,195,32,163,330,251,79,0
2021,Huntingdonshire 016,E02003768,4350,3351,1957,1394,72,72,354,46,308,572,498,74,1
2021,Huntingdonshire 017,E02003769,2812,2205,1289,916,17,17,239,27,212,351,302,49,0
2021,Huntingdonshire 018,E02003770,4401,3052,1421,1631,151,151,556,77,479,642,565,77,0
2021,Huntingdonshire 019,E02003771,2958,1829,1032,797,19,19,471,76,395,637,580,57,2
2021,Huntingdonshire 020,E02003772,2944,2316,1335,981,14,14,151,15,136,463,414,49,0
2021,Huntingdonshire 021,E02003773,4596,2996,1402,1594,64,64,771,177,594,764,684,80,1
2021,Huntingdonshire 022,E02003774,2497,1620,821,799,10,10,521,122,399,345,304,41,1
2021,South Cambridgeshire 001,E02003775,3001,2253,1205,1048,51,51,391,230,161,304,259,45,2
2021,South Cambridgeshire 002,E02003776,2912,2152,1168,984,49,49,336,236,100,368,315,53,7
2021,South Cambridgeshire 003,E02003777,4015,2911,1176,1735,105,105,420,210,210,577,517,60,2
2021,South Cambridgeshire 004,E02003778,2786,1785,889,896,74,74,445,244,201,477,367,110,5
2021,South Cambridgeshire 006,E02003780,4689,2839,1562,1277,178,178,896,338,558,769,701,68,7
2021,South Cambridgeshire 007,E02003781,2705,1782,1026,756,37,37,226,129,97,656,607,49,4
2021,South Cambridgeshire 010,E02003784,3595,2748,1545,1203,98,98,328,187,141,417,353,64,4
2021,South Cambridgeshire 011,E02003785,3839,2347,1401,946,70,70,550,282,268,865,794,71,7
2021,South Cambridgeshire 012,E02003786,2845,1959,1210,749,34,34,419,333,86,429,390,39,4
2021,South Cambridgeshire 013,E02003787,3310,2377,1401,976,72,72,553,400,153,304,229,75,4
2021,South Cambridgeshire 014,E02003788,3369,2431,1267,1164,82,82,486,276,210,367,315,52,3
2021,South Cambridgeshire 015,E02003789,3057,2035,1146,889,71,71,597,424,173,349,294,55,5
2021,South Cambridgeshire 016,E02003790,3918,2824,1640,1184,65,65,607,440,167,419,317,102,3
2021,South Cambridgeshire 017,E02003791,3421,2373,1249,1124,47,47,534,345,189,459,367,92,8
2021,South Cambridgeshire 018,E02003792,4135,2917,1673,1244,100,100,698,436,262,418,336,82,2
2021,South Cambridgeshire 019,E02003793,2868,2079,1092,987,39,39,428,322,106,320,237,83,2
2021,Cheshire West and Chester 022,E02003794,3648,2928,1679,1249,22,22,270,55,215,428,357,71,0
2021,Cheshire West and Chester 025,E02003795,2355,1825,1063,762,18,18,207,62,145,305,172,133,0
2021,Cheshire West and Chester 027,E02003796,3315,2192,1313,879,21,21,760,186,574,339,288,51,3
2021,Cheshire West and Chester 028,E02003797,4198,3192,1732,1460,46,46,256,42,214,704,633,71,0
2021,Cheshire West and Chester 029,E02003798,2567,1229,613,616,4,4,1014,295,719,320,277,43,0
2021,Cheshire West and Chester 031,E02003799,3212,1539,835,704,22,22,1209,367,842,437,330,107,5
2021,Cheshire West and Chester 030,E02003800,3004,2473,1451,1022,57,57,193,39,154,281,230,51,0
2021,Cheshire West and Chester 032,E02003801,2976,2391,1270,1121,12,12,302,84,218,270,240,30,1
2021,Cheshire West and Chester 033,E02003802,4530,1555,776,779,99,99,1095,187,908,1778,1663,115,3
2021,Cheshire West and Chester 034,E02003803,4329,1752,959,793,101,101,490,63,427,1985,1832,153,1
2021,Cheshire West and Chester 036,E02003804,3292,2024,1054,970,24,24,334,52,282,907,847,60,3
2021,Cheshire West and Chester 039,E02003805,2606,2168,1268,900,22,22,156,31,125,260,213,47,0
2021,Cheshire West and Chester 041,E02003806,3426,2816,1369,1447,103,103,178,34,144,329,270,59,0
2021,Cheshire West and Chester 043,E02003807,4075,2967,1867,1100,8,8,285,118,167,814,731,83,1
2021,Cheshire West and Chester 044,E02003808,2837,1580,754,826,15,15,739,295,444,498,448,50,5
2021,Cheshire West and Chester 046,E02003809,3520,2394,1441,953,64,64,256,41,215,804,616,188,2
2021,Cheshire West and Chester 047,E02003810,4171,3020,1740,1280,77,77,455,60,395,619,500,119,0
2021,Cheshire East 022,E02003811,3155,2536,1463,1073,75,75,235,36,199,309,253,56,0
2021,Cheshire East 023,E02003812,2849,2304,1347,957,44,44,216,29,187,285,246,39,0
2021,Cheshire East 024,E02003813,2787,2095,1235,860,19,19,293,57,236,378,321,57,2
2021,Cheshire East 025,E02003814,3487,2565,1110,1455,46,46,432,107,325,443,389,54,1
2021,Cheshire East 026,E02003815,3268,1936,998,938,47,47,910,267,643,373,337,36,2
2021,Cheshire East 027,E02003816,3651,2333,1257,1076,37,37,534,86,448,742,648,94,5
2021,Cheshire East 028,E02003817,3409,2865,1647,1218,54,54,230,30,200,260,224,36,0
2021,Cheshire East 029,E02003818,2506,2224,1352,872,5,5,31,10,21,246,219,27,0
2021,Cheshire East 030,E02003819,3000,2371,1381,990,53,53,220,25,195,356,298,58,0
2021,Cheshire East 031,E02003820,4127,3124,1329,1795,101,101,330,33,297,572,511,61,0
2021,Cheshire East 032,E02003821,2724,1914,1103,811,20,20,482,90,392,308,271,37,0
2021,Cheshire East 033,E02003822,5128,4158,2404,1754,52,52,388,73,315,529,428,101,1
2021,Cheshire East 040,E02003823,3124,2416,1480,936,21,21,372,78,294,312,256,56,3
2021,Cheshire East 042,E02003824,2797,2193,1113,1080,53,53,285,50,235,265,222,43,1
2021,Cheshire East 034,E02003825,2642,2175,969,1206,9,9,83,19,64,375,327,48,0
2021,Cheshire East 035,E02003826,3591,2063,904,1159,65,65,855,329,526,594,533,61,14
2021,Cheshire East 036,E02003827,4221,1841,1013,828,19,19,1121,371,750,1236,1139,97,4
2021,Cheshire East 037,E02003828,2660,1395,705,690,8,8,758,296,462,495,458,37,4
2021,Cheshire East 038,E02003829,2575,2000,1275,725,14,14,162,24,138,399,346,53,0
2021,Cheshire East 039,E02003830,3562,1507,713,794,23,23,753,236,517,1278,1207,71,1
2021,Cheshire East 041,E02003831,4275,3460,1898,1562,48,48,255,46,209,511,430,81,1
2021,Cheshire East 043,E02003832,2737,1165,636,529,31,31,217,44,173,1322,1205,117,2
2021,Cheshire East 044,E02003833,2731,2046,1043,1003,15,15,386,140,246,282,247,35,2
2021,Cheshire East 045,E02003834,2940,1458,705,753,26,26,458,146,312,993,922,71,5
2021,Cheshire East 046,E02003835,3627,3295,1997,1298,17,17,85,26,59,230,182,48,0
2021,Cheshire East 047,E02003836,3485,2263,1468,795,34,34,547,106,441,640,589,51,1
2021,Cheshire East 048,E02003838,3666,2946,1479,1467,88,88,268,56,212,362,296,66,2
2021,Cheshire East 050,E02003839,3431,2267,1438,829,40,40,479,87,392,643,580,63,2
2021,Cheshire East 051,E02003840,4633,3652,2335,1317,42,42,388,62,326,550,428,122,1
2021,Cheshire West and Chester 001,E02003841,3644,2462,1535,927,13,13,654,293,361,512,445,67,3
2021,Cheshire West and Chester 004,E02003842,2510,2139,1356,783,6,6,117,45,72,247,201,46,1
2021,Cheshire West and Chester 005,E02003843,2918,1874,1006,868,66,66,540,334,206,434,367,67,4
2021,Cheshire West and Chester 006,E02003844,2978,2436,1504,932,11,11,232,134,98,298,262,36,1
2021,Cheshire West and Chester 007,E02003845,5116,2110,738,1372,52,52,1458,836,622,1487,1383,104,9
2021,Cheshire West and Chester 008,E02003846,2966,1435,650,785,7,7,1064,790,274,450,393,57,10
2021,Cheshire West and Chester 009,E02003847,4163,3739,1944,1795,42,42,71,24,47,311,264,47,0
2021,Cheshire West and Chester 010,E02003848,2225,1286,640,646,6,6,611,496,115,313,278,35,9
2021,Cheshire West and Chester 011,E02003849,3646,1610,630,980,76,76,1458,1032,426,493,436,57,9
2021,Cheshire West and Chester 013,E02003850,2242,1760,968,792,1,1,270,219,51,205,162,43,6
2021,Cheshire West and Chester 014,E02003851,2410,2141,1186,955,11,11,61,34,27,197,158,39,0
2021,Cheshire West and Chester 016,E02003852,2788,2516,1427,1089,12,12,21,10,11,239,194,45,0
2021,Cheshire East 001,E02003853,2693,2247,1234,1013,23,23,127,28,99,295,245,50,1
2021,Cheshire East 002,E02003854,2737,2214,1271,943,12,12,284,47,237,227,193,34,0
2021,Cheshire East 003,E02003855,2818,2510,1611,899,7,7,68,20,48,233,197,36,0
2021,Cheshire East 004,E02003856,5171,3067,1544,1523,81,81,1201,141,1060,822,749,73,0
2021,Cheshire East 005,E02003857,2873,2021,1012,1009,32,32,364,56,308,456,413,43,0
2021,Cheshire East 006,E02003858,3073,2336,1379,957,5,5,140,15,125,591,527,64,1
2021,Cheshire East 007,E02003859,4988,3805,2242,1563,33,33,285,44,241,864,742,122,1
2021,Cheshire East 008,E02003860,2961,2588,1375,1213,7,7,64,6,58,302,249,53,0
2021,Cheshire East 009,E02003861,2901,1861,1017,844,15,15,619,108,511,405,358,47,1
2021,Cheshire East 011,E02003862,2173,1876,1198,678,3,3,79,10,69,214,176,38,1
2021,Cheshire East 010,E02003863,2977,2322,1402,920,7,7,189,29,160,458,404,54,1
2021,Cheshire East 012,E02003864,3928,2980,1761,1219,15,15,278,57,221,655,583,72,0
2021,Cheshire East 013,E02003865,3662,2650,1443,1207,27,27,290,74,216,694,621,73,1
2021,Cheshire East 014,E02003866,2632,2299,1314,985,22,22,87,11,76,224,186,38,0
2021,Cheshire East 015,E02003867,3300,2417,1318,1099,22,22,402,95,307,459,412,47,0
2021,Cheshire East 016,E02003868,4040,2487,1331,1156,29,29,896,232,664,623,553,70,5
2021,Cheshire East 017,E02003869,3251,2540,1393,1147,39,39,223,33,190,449,382,67,0
2021,Cheshire East 018,E02003870,5370,2991,1416,1575,45,45,506,50,456,1825,1677,148,3
2021,Cheshire East 019,E02003871,3067,1907,999,908,20,20,842,282,560,293,233,60,5
2021,Cheshire East 020,E02003872,4445,3593,2215,1378,67,67,324,67,257,460,364,96,1
2021,Cheshire East 021,E02003873,2842,1441,637,804,29,29,905,243,662,462,406,56,5
2021,Cheshire West and Chester 002,E02003874,4117,3137,1850,1287,53,53,432,159,273,493,423,70,2
2021,Cheshire West and Chester 003,E02003875,2804,2429,1534,895,18,18,158,56,102,199,158,41,0
2021,Cheshire West and Chester 012,E02003876,2474,1755,970,785,21,21,300,141,159,396,341,55,2
2021,Cheshire West and Chester 015,E02003877,4243,3480,2081,1399,100,100,227,56,171,435,367,68,1
2021,Cheshire West and Chester 017,E02003878,3895,3064,1748,1316,48,48,372,140,232,411,331,80,0
2021,Cheshire West and Chester 018,E02003879,4155,2658,979,1679,55,55,513,125,388,926,854,72,3
2021,Cheshire West and Chester 019,E02003880,2802,1930,1085,845,15,15,527,261,266,327,281,46,3
2021,Cheshire West and Chester 020,E02003881,2731,1618,827,791,21,21,408,142,266,680,636,44,4
2021,Cheshire West and Chester 021,E02003882,4085,2472,1245,1227,80,80,948,487,461,572,501,71,13
2021,Cheshire West and Chester 023,E02003883,4800,3857,2009,1848,153,153,216,53,163,571,512,59,3
2021,Cheshire West and Chester 024,E02003884,3784,3176,1850,1326,49,49,238,85,153,321,257,64,0
2021,Cheshire West and Chester 026,E02003885,2761,2156,1179,977,54,54,242,79,163,306,257,49,3
2021,Cheshire West and Chester 035,E02003886,2624,1648,803,845,12,12,555,260,295,408,368,40,1
2021,Cheshire West and Chester 037,E02003887,2888,2051,937,1114,53,53,360,151,209,421,363,58,3
2021,Cheshire West and Chester 038,E02003888,2867,1536,779,757,23,23,738,338,400,554,498,56,16
2021,Cheshire West and Chester 040,E02003889,2673,1231,631,600,76,76,1072,478,594,288,249,39,6
2021,Cheshire West and Chester 042,E02003890,2983,2014,975,1039,44,44,463,80,383,446,390,56,16
2021,Cheshire West and Chester 045,E02003891,2801,2188,1373,815,50,50,195,72,123,366,313,53,2
2021,Cornwall 010,E02003892,3040,2368,1566,802,25,25,261,183,78,384,316,68,2
2021,Cornwall 012,E02003893,2889,2250,1491,759,11,11,245,186,59,379,274,105,4
2021,Cornwall 013,E02003894,3717,2575,1640,935,45,45,370,187,183,723,617,106,4
2021,Cornwall 016,E02003895,4118,2653,1539,1114,70,70,551,229,322,839,718,121,5
2021,Cornwall 017,E02003896,2787,1479,945,534,24,24,632,439,193,638,573,65,14
2021,Cornwall 022,E02003897,2301,1907,1123,784,21,21,60,27,33,313,267,46,0
2021,Cornwall 023,E02003898,2975,2220,1445,775,14,14,244,183,61,494,400,94,3
2021,Cornwall 025,E02003899,2382,1565,934,631,22,22,508,387,121,272,239,33,15
2021,Cornwall 026,E02003900,3166,2230,1279,951,26,26,346,215,131,559,494,65,5
2021,Cornwall 028,E02003901,3707,2509,1785,724,64,64,592,432,160,538,405,133,4
2021,Cornwall 029,E02003902,2419,1517,882,635,5,5,388,273,115,505,405,100,4
2021,Cornwall 034,E02003903,2881,2027,1342,685,20,20,324,216,108,509,429,80,1
2021,Cornwall 037,E02003904,2444,1756,1275,481,22,22,188,113,75,476,385,91,2
2021,Cornwall 032,E02003905,2914,2075,1170,905,61,61,260,108,152,515,433,82,3
2021,Cornwall 033,E02003906,2683,1885,1163,722,67,67,274,139,135,455,365,90,2
2021,Cornwall 040,E02003907,3683,2595,1588,1007,62,62,368,152,216,652,521,131,6
2021,Cornwall 042,E02003908,3699,2340,1450,890,39,39,672,445,227,646,571,75,2
2021,Cornwall 043,E02003909,4574,2839,1673,1166,58,58,722,449,273,943,828,115,12
2021,Cornwall 044,E02003910,3364,1896,1137,759,59,59,485,221,264,917,828,89,7
2021,Cornwall 047,E02003911,3957,3045,1938,1107,44,44,253,148,105,613,517,96,2
2021,Cornwall 048,E02003912,3670,2495,1708,787,45,45,406,241,165,720,570,150,4
2021,Cornwall 056,E02003913,2677,2055,1451,604,17,17,250,191,59,355,281,74,0
2021,Cornwall 060,E02003914,3479,1898,1040,858,39,39,514,320,194,1023,908,115,5
2021,Cornwall 062,E02003915,3426,1475,913,562,12,12,1001,831,170,933,833,100,5
2021,Cornwall 063,E02003916,2898,1717,1172,545,14,14,148,39,109,1017,921,96,2
2021,Cornwall 064,E02003917,3567,2674,1578,1096,39,39,310,119,191,544,453,91,0
2021,Cornwall 045,E02003918,3183,2291,1374,917,28,28,318,92,226,544,458,86,2
2021,Cornwall 046,E02003919,3422,1844,1023,821,33,33,873,224,649,667,573,94,5
2021,Cornwall 049,E02003920,3648,2483,1369,1114,25,25,233,41,192,907,791,116,0
2021,Cornwall 050,E02003921,2759,2010,1277,733,30,30,280,46,234,439,366,73,0
2021,Cornwall 051,E02003922,3863,2460,1367,1093,62,62,639,102,537,699,614,85,3
2021,Cornwall 052,E02003923,4099,2384,1343,1041,118,118,525,134,391,1072,973,99,0
2021,Cornwall 053,E02003924,3354,2023,1311,712,23,23,613,178,435,687,587,100,8
2021,Cornwall 055,E02003925,3080,1996,1223,773,30,30,532,166,366,519,449,70,3
2021,Cornwall 059,E02003926,3410,2667,1606,1061,42,42,198,38,160,503,400,103,0
2021,Cornwall 066,E02003927,4110,3154,2079,1075,53,53,322,78,244,581,470,111,0
2021,Cornwall 071,E02003928,5214,3330,1864,1466,58,58,622,142,480,1203,848,355,1
2021,Cornwall 072,E02003929,3122,2307,1603,704,36,36,353,75,278,425,337,88,1
2021,Cornwall 073,E02003930,3808,2677,1935,742,37,37,453,79,374,641,499,142,0
2021,Cornwall 001,E02003931,4848,3070,2140,930,78,78,677,268,409,1018,929,89,5
2021,Cornwall 002,E02003932,3081,2261,1574,687,20,20,285,146,139,512,393,119,3
2021,Cornwall 003,E02003933,3187,2364,1678,686,8,8,241,130,111,574,455,119,0
2021,Cornwall 004,E02003934,3037,2092,1427,665,22,22,364,182,182,556,452,104,3
2021,Cornwall 005,E02003935,4438,2463,1359,1104,35,35,791,444,347,1145,1031,114,4
2021,Cornwall 006,E02003936,3582,2803,1920,883,22,22,184,103,81,570,456,114,3
2021,Cornwall 007,E02003937,2356,1544,1086,458,29,29,288,163,125,489,354,135,6
2021,Cornwall 008,E02003938,2869,1778,1168,610,59,59,474,307,167,555,409,146,3
2021,Cornwall 009,E02003939,3149,2062,1368,694,37,37,466,273,193,582,505,77,2
2021,Cornwall 011,E02003940,2749,2070,1465,605,23,23,242,148,94,410,302,108,4
2021,Cornwall 014,E02003941,3740,2207,1241,966,51,51,576,253,323,904,824,80,2
2021,Cornwall 015,E02003942,3498,1851,1011,840,11,11,941,663,278,683,608,75,12
2021,Cornwall 054,E02003943,3237,1923,1323,600,56,56,699,108,591,557,440,117,2
2021,Cornwall 057,E02003944,4514,2840,1777,1063,109,109,796,159,637,766,641,125,3
2021,Cornwall 058,E02003945,2686,2095,1440,655,33,33,113,23,90,445,359,86,0
2021,Cornwall 061,E02003946,4066,2757,1838,919,93,93,523,81,442,691,538,153,2
2021,Cornwall 065,E02003947,2889,2017,1399,618,20,20,251,48,203,601,478,123,0
2021,Cornwall 067,E02003948,3909,2177,1467,710,39,39,993,238,755,700,606,94,0
2021,Cornwall 068,E02003949,3614,1674,1146,528,21,21,737,132,605,1179,1056,123,3
2021,Cornwall 069,E02003950,2522,1706,1210,496,14,14,333,51,282,468,367,101,1
2021,Cornwall 070,E02003951,2848,1925,1367,558,9,9,333,57,276,576,476,100,5
2021,Cornwall 018,E02003952,4098,2730,1382,1348,124,124,445,79,366,798,633,165,1
2021,Cornwall 019,E02003953,4473,2996,1832,1164,64,64,449,100,349,963,805,158,1
2021,Cornwall 020,E02003954,3559,1957,1080,877,50,50,404,61,343,1145,1026,119,3
2021,Cornwall 021,E02003955,4459,2813,1605,1208,38,38,458,81,377,1149,996,153,1
2021,Cornwall 024,E02003956,3251,2069,1182,887,53,53,430,99,331,697,574,123,2
2021,Cornwall 027,E02003957,4728,3234,1987,1247,29,29,457,92,365,1007,862,145,1
2021,Cornwall 030,E02003958,3462,2395,1451,944,82,82,405,107,298,580,481,99,0
2021,Cornwall 031,E02003959,2968,1980,1147,833,16,16,386,88,298,585,514,71,1
2021,Cornwall 035,E02003960,2604,1946,1340,606,13,13,150,32,118,494,425,69,1
2021,Cornwall 036,E02003961,4232,3191,2001,1190,51,51,349,68,281,639,540,99,2
2021,Cornwall 038,E02003962,3129,2043,1129,914,46,46,328,83,245,710,629,81,2
2021,Cornwall 039,E02003963,4581,2468,1530,938,57,57,958,238,720,1094,937,157,4
2021,Cornwall 041,E02003964,3675,2774,1983,791,35,35,182,47,135,684,531,153,0
2021,Allerdale 001,E02003965,5020,3551,2291,1260,20,20,793,110,683,656,524,132,0
2021,Allerdale 002,E02003966,3066,2461,1719,742,24,24,164,23,141,416,271,145,1
2021,Allerdale 003,E02003967,3605,2579,1681,898,13,13,508,49,459,504,378,126,1
2021,Allerdale 004,E02003968,4002,2889,1747,1142,11,11,605,82,523,496,409,87,1
2021,Allerdale 005,E02003969,2906,1433,847,586,7,7,1150,165,985,316,257,59,0
2021,Allerdale 006,E02003970,3828,2760,1683,1077,33,33,505,51,454,530,454,76,0
2021,Allerdale 007,E02003971,3560,2714,1840,874,35,35,398,45,353,413,327,86,0
2021,Allerdale 008,E02003972,4215,2888,1646,1242,13,13,722,90,632,588,498,90,4
2021,Allerdale 009,E02003973,4188,2045,1105,940,6,6,1529,216,1313,605,516,89,3
2021,Allerdale 010,E02003974,3498,2180,1324,856,40,40,1061,152,909,216,168,48,1
2021,Allerdale 011,E02003975,3178,2603,1477,1126,0,0,320,39,281,255,187,68,0
2021,Allerdale 012,E02003976,2907,1941,1410,531,39,39,557,74,483,370,254,116,0
2021,Barrow-in-Furness 001,E02003977,2782,2325,1273,1052,4,4,67,32,35,384,341,43,2
2021,Barrow-in-Furness 002,E02003978,2647,2065,1140,925,2,2,196,152,44,384,326,58,0
2021,Barrow-in-Furness 003,E02003979,3460,3145,2002,1143,6,6,59,38,21,249,161,88,1
2021,Barrow-in-Furness 004,E02003980,3282,1672,870,802,12,12,1042,821,221,547,470,77,9
2021,Barrow-in-Furness 005,E02003981,2934,2311,1127,1184,5,5,96,47,49,520,449,71,2
2021,Barrow-in-Furness 006,E02003982,3386,2843,1489,1354,6,6,300,271,29,234,181,53,3
2021,Barrow-in-Furness 007,E02003983,3322,2151,1015,1136,1,1,614,488,126,544,466,78,12
2021,Barrow-in-Furness 008,E02003984,3297,1467,832,635,9,9,558,152,406,1261,1184,77,2
2021,Barrow-in-Furness 009,E02003985,3145,2432,1349,1083,5,5,318,250,68,387,327,60,3
2021,Barrow-in-Furness 010,E02003986,3006,2050,1153,897,3,3,201,137,64,752,683,69,0
2021,Carlisle 001,E02003987,2713,1935,1234,701,15,15,223,37,186,540,416,124,0
2021,Carlisle 002,E02003988,3035,2012,1306,706,14,14,509,63,446,497,396,101,3
2021,Carlisle 003,E02003989,3488,2748,1706,1042,43,43,236,47,189,461,394,67,0
2021,Carlisle 004,E02003990,4756,3836,2131,1705,101,101,276,45,231,543,466,77,0
2021,Carlisle 005,E02003991,3242,2840,1744,1096,21,21,141,14,127,240,172,68,0
2021,Carlisle 006,E02003992,4159,2044,1158,886,74,74,504,61,443,1536,1429,107,1
2021,Carlisle 007,E02003993,3944,3307,2139,1168,18,18,158,21,137,460,369,91,1
2021,Carlisle 008,E02003994,3595,1964,1084,880,3,3,734,163,571,890,796,94,4
2021,Carlisle 009,E02003995,4769,2657,1378,1279,33,33,1475,289,1186,601,518,83,3
2021,Carlisle 010,E02003996,4668,2594,1270,1324,22,22,450,52,398,1602,1456,146,0
2021,Carlisle 011,E02003997,4220,2098,999,1099,6,6,1489,369,1120,621,539,82,6
2021,Carlisle 012,E02003998,2911,1721,928,793,29,29,839,197,642,317,261,56,5
2021,Carlisle 013,E02003999,5162,4291,2349,1942,39,39,240,46,194,591,475,116,1
2021,Copeland 001,E02004000,2294,1569,938,631,1,1,514,131,383,209,158,51,1
2021,Copeland 002,E02004001,2712,1568,898,670,47,47,641,164,477,452,387,65,4
2021,Copeland 003,E02004002,4267,3490,1966,1524,6,6,479,161,318,291,230,61,1
2021,Copeland 004,E02004003,5401,3688,2197,1491,6,6,1043,260,783,660,537,123,4
2021,Copeland 005,E02004004,4349,2730,1405,1325,2,2,1227,507,720,382,309,73,8
2021,Copeland 006,E02004005,3527,2425,1449,976,10,10,711,224,487,378,308,70,3
2021,Copeland 007,E02004006,3896,3229,2086,1143,13,13,236,56,180,417,307,110,1
2021,Copeland 008,E02004007,4344,3137,2049,1088,13,13,578,134,444,611,490,121,5
2021,Eden 001,E02004008,2819,2137,1483,654,20,20,223,33,190,439,334,105,0
2021,Eden 002,E02004009,2667,2008,1329,679,19,19,142,24,118,498,394,104,0
2021,Eden 003,E02004010,3672,1840,1096,744,65,65,958,143,815,809,713,96,0
2021,Eden 004,E02004011,4914,3790,2451,1339,57,57,384,87,297,683,543,140,0
2021,Eden 005,E02004012,2455,1742,1247,495,13,13,224,41,183,476,308,168,0
2021,Eden 006,E02004013,4623,3329,2266,1063,56,56,355,29,326,883,704,179,0
2021,Eden 007,E02004014,3462,2516,1789,727,25,25,255,42,213,666,528,138,0
2021,South Lakeland 001,E02004015,2744,1464,1118,346,12,12,589,144,445,679,517,162,0
2021,South Lakeland 002,E02004016,3628,2315,1567,748,33,33,503,222,281,771,643,128,6
2021,South Lakeland 003,E02004017,4077,2781,1683,1098,21,21,564,239,325,710,610,100,1
2021,South Lakeland 004,E02004018,3940,2139,1263,876,14,14,877,408,469,901,809,92,9
2021,South Lakeland 005,E02004019,3400,2784,1816,968,16,16,189,102,87,410,320,90,1
2021,South Lakeland 006,E02004020,3973,3088,1844,1244,50,50,329,118,211,505,415,90,1
2021,South Lakeland 007,E02004021,2428,1714,1182,532,7,7,176,49,127,531,422,109,0
2021,South Lakeland 008,E02004022,2510,1894,1297,597,9,9,201,59,142,406,315,91,0
2021,South Lakeland 009,E02004023,2713,1891,1384,507,27,27,265,124,141,530,418,112,0
2021,South Lakeland 010,E02004024,3290,2733,1817,916,11,11,102,40,62,444,357,87,0
2021,South Lakeland 011,E02004025,3629,2873,1923,950,17,17,309,145,164,430,343,87,0
2021,South Lakeland 012,E02004026,3869,2544,1410,1134,19,19,567,370,197,734,623,111,5
2021,South Lakeland 013,E02004027,3876,2996,2162,834,31,31,270,96,174,577,457,120,2
2021,South Lakeland 014,E02004028,3583,3054,1929,1125,11,11,171,85,86,346,277,69,1
2021,Amber Valley 001,E02004029,3330,2051,1075,976,26,26,702,203,499,550,487,63,1
2021,Amber Valley 002,E02004030,2738,2113,1386,727,17,17,317,98,219,289,234,55,2
2021,Amber Valley 003,E02004031,3286,1534,806,728,7,7,1201,391,810,538,465,73,6
2021,Amber Valley 004,E02004032,3811,3062,1828,1234,18,18,242,82,160,487,413,74,2
2021,Amber Valley 005,E02004033,4099,2915,1586,1329,42,42,331,110,221,810,728,82,1
2021,Amber Valley 006,E02004034,3165,2582,1655,927,10,10,262,89,173,308,251,57,3
2021,Amber Valley 007,E02004035,2821,2387,1574,813,6,6,138,56,82,290,227,63,0
2021,Amber Valley 008,E02004036,4582,3058,1756,1302,28,28,848,285,563,637,552,85,11
2021,Amber Valley 009,E02004037,3372,2764,1568,1196,28,28,190,36,154,387,337,50,3
2021,Amber Valley 010,E02004038,3668,2484,1436,1048,18,18,407,128,279,758,682,76,1
2021,Amber Valley 011,E02004039,3449,2722,1522,1200,14,14,258,87,171,453,396,57,2
2021,Amber Valley 012,E02004040,4062,3129,1551,1578,17,17,282,97,185,632,558,74,2
2021,Amber Valley 013,E02004041,3269,2391,1251,1140,8,8,281,85,196,586,528,58,3
2021,Amber Valley 015,E02004043,3244,2462,1365,1097,24,24,475,123,352,280,225,55,3
2021,Amber Valley 016,E02004044,3756,2991,1674,1317,18,18,233,63,170,510,436,74,4
2021,Bolsover 001,E02004045,4312,3314,1752,1562,6,6,341,265,76,646,569,77,5
2021,Bolsover 002,E02004046,2787,1918,1079,839,7,7,540,486,54,318,267,51,4
2021,Bolsover 003,E02004047,2753,1425,725,700,5,5,606,462,144,707,652,55,10
2021,Bolsover 004,E02004048,3098,1871,1001,870,13,13,589,458,131,625,577,48,0
2021,Bolsover 005,E02004049,3603,2618,1532,1086,18,18,576,487,89,383,328,55,8
2021,Bolsover 006,E02004050,3261,1904,934,970,18,18,887,752,135,446,389,57,6
2021,Bolsover 007,E02004051,4221,2429,1379,1050,10,10,670,464,206,1106,1018,88,6
2021,Bolsover 008,E02004052,3762,2666,1365,1301,21,21,527,489,38,538,457,81,10
2021,Bolsover 009,E02004053,3430,2158,1088,1070,12,12,603,480,123,648,565,83,9
2021,Bolsover 010,E02004054,4033,2962,1537,1425,5,5,420,304,116,641,552,89,5
2021,Chesterfield 001,E02004055,3305,2100,1253,847,7,7,695,572,123,497,445,52,6
2021,Chesterfield 002,E02004056,3326,1711,908,803,5,5,1160,1126,34,443,403,40,7
2021,Chesterfield 003,E02004057,3552,2191,1075,1116,8,8,605,419,186,739,652,87,9
2021,Chesterfield 004,E02004058,3815,1881,1023,858,10,10,1421,1332,89,495,426,69,8
2021,Chesterfield 005,E02004059,3313,2439,1427,1012,2,2,508,428,80,360,307,53,4
2021,Chesterfield 006,E02004060,3223,2160,1251,909,11,11,718,530,188,330,286,44,4
2021,Chesterfield 007,E02004061,3554,2184,1206,978,12,12,763,680,83,584,524,60,11
2021,Chesterfield 008,E02004062,3696,2297,1374,923,45,45,1079,958,121,267,221,46,8
2021,Chesterfield 009,E02004063,3612,2723,1674,1049,7,7,336,278,58,542,458,84,4
2021,Chesterfield 010,E02004064,4740,2115,1014,1101,17,17,671,430,241,1934,1781,153,3
2021,Chesterfield 011,E02004065,3678,3297,2154,1143,8,8,53,39,14,320,253,67,0
2021,Chesterfield 012,E02004066,5229,3701,2119,1582,24,24,510,319,191,990,879,111,4
2021,Chesterfield 013,E02004067,3009,1273,770,503,2,2,1446,1315,131,278,245,33,10
2021,Derbyshire Dales 001,E02004068,3308,2436,1629,807,39,39,422,84,338,411,310,101,0
2021,Derbyshire Dales 002,E02004069,2953,2137,1498,639,11,11,236,36,200,569,410,159,0
2021,Derbyshire Dales 005,E02004072,4231,3313,2159,1154,48,48,407,78,329,462,385,77,1
2021,Derbyshire Dales 006,E02004073,4181,2713,1866,847,16,16,825,202,623,623,517,106,4
2021,Derbyshire Dales 007,E02004074,2705,1953,1326,627,34,34,395,93,302,323,272,51,0
2021,Derbyshire Dales 008,E02004075,3224,2456,1696,760,26,26,191,45,146,551,443,108,0
2021,Derbyshire Dales 009,E02004076,3334,2086,1153,933,87,87,725,214,511,436,377,59,0
2021,Derbyshire Dales 010,E02004077,3303,2559,1565,994,19,19,149,18,131,574,472,102,2
2021,Erewash 001,E02004078,3159,1561,884,677,4,4,1003,377,626,585,529,56,6
2021,Erewash 003,E02004080,4577,2643,1399,1244,24,24,526,116,410,1381,1270,111,3
2021,Erewash 004,E02004081,2519,1990,1203,787,7,7,289,56,233,232,188,44,1
2021,Erewash 005,E02004082,2596,2281,1361,920,8,8,54,19,35,253,206,47,0
2021,Erewash 006,E02004083,3592,2677,1219,1458,24,24,327,72,255,564,497,67,0
2021,Erewash 007,E02004084,2620,1649,885,764,4,4,651,219,432,312,266,46,4
2021,Erewash 008,E02004085,3801,2777,1528,1249,20,20,481,130,351,522,447,75,1
2021,Erewash 009,E02004086,3149,2430,1420,1010,25,25,325,93,232,367,317,50,2
2021,Erewash 010,E02004087,3439,2270,1088,1182,15,15,532,152,380,619,559,60,3
2021,Erewash 011,E02004088,3223,2771,1559,1212,3,3,69,17,52,379,331,48,1
2021,Erewash 012,E02004089,3479,1651,756,895,29,29,666,150,516,1130,1035,95,3
2021,Erewash 013,E02004090,2792,2025,1226,799,1,1,337,94,243,428,370,58,1
2021,Erewash 014,E02004091,4180,3240,1736,1504,20,20,205,29,176,713,633,80,2
2021,Erewash 015,E02004092,4184,2909,1507,1402,38,38,699,181,518,535,471,64,3
2021,High Peak 001,E02004093,2854,1976,991,985,13,13,326,208,118,535,467,68,4
2021,High Peak 002,E02004094,3009,1766,875,891,4,4,900,827,73,324,275,49,15
2021,High Peak 003,E02004095,4863,3004,1556,1448,22,22,695,478,217,1135,1003,132,7
2021,High Peak 004,E02004096,4078,3582,1979,1603,12,12,134,79,55,350,291,59,0
2021,High Peak 005,E02004097,3428,2647,1538,1109,11,11,96,77,19,671,584,87,3
2021,High Peak 006,E02004098,3324,2255,1261,994,40,40,641,491,150,383,323,60,5
2021,High Peak 008,E02004100,3552,2815,1664,1151,30,30,243,183,60,457,368,89,7
2021,High Peak 010,E02004102,3858,2257,1456,801,31,31,468,213,255,1099,1001,98,3
2021,High Peak 011,E02004103,2902,1709,956,753,15,15,727,563,164,445,382,63,6
2021,High Peak 012,E02004104,3110,2594,1485,1109,20,20,152,73,79,344,284,60,0
2021,North East Derbyshire 001,E02004105,3985,2838,1569,1269,17,17,733,643,90,391,323,68,6
2021,North East Derbyshire 002,E02004106,3229,2716,1762,954,5,5,215,186,29,292,235,57,1
2021,North East Derbyshire 004,E02004108,3535,2212,1193,1019,17,17,935,678,257,361,307,54,10
2021,North East Derbyshire 005,E02004109,2931,2548,1653,895,8,8,178,141,37,195,146,49,2
2021,North East Derbyshire 006,E02004110,3166,2773,1637,1136,18,18,148,96,52,227,178,49,0
2021,North East Derbyshire 007,E02004111,2560,1885,1129,756,24,24,401,225,176,247,195,52,3
2021,North East Derbyshire 008,E02004112,2868,2489,1702,787,4,4,182,137,45,192,146,46,1
2021,North East Derbyshire 009,E02004113,4619,2296,1197,1099,27,27,1744,1510,234,538,481,57,14
2021,North East Derbyshire 010,E02004114,3805,3175,1912,1263,59,59,278,204,74,291,236,55,2
2021,North East Derbyshire 011,E02004115,4058,2985,1690,1295,22,22,567,489,78,472,402,70,12
2021,North East Derbyshire 012,E02004116,4021,2119,1106,1013,20,20,1301,1116,185,573,492,81,8
2021,North East Derbyshire 013,E02004117,3540,2373,1386,987,27,27,826,670,156,302,244,58,12
2021,South Derbyshire 001,E02004118,3127,2504,1260,1244,12,12,167,102,65,442,363,79,2
2021,South Derbyshire 002,E02004119,4895,3724,1614,2110,50,50,340,193,147,781,707,74,0
2021,South Derbyshire 003,E02004120,4486,3554,1610,1944,77,77,318,101,217,536,470,66,1
2021,South Derbyshire 004,E02004121,3876,3174,1490,1684,51,51,284,118,166,366,313,53,1
2021,South Derbyshire 005,E02004122,2727,2253,1277,976,25,25,137,62,75,311,234,77,1
2021,South Derbyshire 006,E02004123,3049,2164,1294,870,19,19,315,210,105,546,480,66,5
2021,South Derbyshire 007,E02004124,3195,2284,1248,1036,6,6,520,453,67,380,330,50,5
2021,South Derbyshire 008,E02004125,3797,2637,1391,1246,11,11,495,369,126,648,586,62,6
2021,South Derbyshire 009,E02004126,3385,2291,1212,1079,32,32,541,364,177,509,452,57,12
2021,South Derbyshire 011,E02004128,4887,3785,1941,1844,31,31,483,375,108,582,486,96,6
2021,East Devon 001,E02004129,2514,1980,1338,642,19,19,133,56,77,382,291,91,0
2021,East Devon 002,E02004130,3028,1867,1257,610,10,10,500,361,139,648,581,67,3
2021,East Devon 003,E02004131,2472,1851,1136,715,19,19,197,125,72,404,358,46,1
2021,East Devon 004,E02004132,3722,2893,1732,1161,40,40,245,152,93,542,412,130,2
2021,East Devon 005,E02004133,4410,2992,1963,1029,88,88,618,347,271,710,616,94,2
2021,East Devon 007,E02004135,3743,2911,2138,773,13,13,365,238,127,453,340,113,1
2021,East Devon 008,E02004136,4013,3036,1897,1139,91,91,354,198,156,528,457,71,4
2021,East Devon 009,E02004137,2418,1847,1400,447,8,8,170,134,36,393,293,100,0
2021,East Devon 010,E02004138,3872,2820,2154,666,30,30,292,182,110,727,647,80,3
2021,East Devon 011,E02004139,3267,2291,1690,601,69,69,546,341,205,355,318,37,6
2021,East Devon 012,E02004140,2708,2114,1733,381,16,16,126,74,52,448,361,87,4
2021,East Devon 013,E02004141,2675,1963,1265,698,16,16,234,164,70,459,391,68,3
2021,East Devon 014,E02004142,2383,1853,1179,674,31,31,130,83,47,366,260,106,3
2021,East Devon 015,E02004143,2764,2190,1394,796,15,15,202,134,68,356,290,66,1
2021,East Devon 016,E02004144,3033,2410,1562,848,16,16,197,66,131,408,330,78,2
2021,East Devon 017,E02004145,2963,2302,1740,562,30,30,247,166,81,382,319,63,2
2021,East Devon 018,E02004146,3150,2084,1119,965,35,35,663,427,236,364,299,65,4
2021,East Devon 019,E02004147,3370,1814,1026,788,19,19,170,62,108,1364,1230,134,3
2021,East Devon 020,E02004148,3681,2621,1919,702,18,18,532,451,81,507,439,68,3
2021,Exeter 001,E02004149,2684,1986,1234,752,16,16,146,53,93,536,486,50,0
2021,Exeter 002,E02004150,2830,1426,705,721,14,14,715,603,112,666,618,48,9
2021,Exeter 003,E02004151,4095,2824,1480,1344,101,101,682,281,401,484,421,63,4
2021,Exeter 004,E02004152,3066,947,537,410,15,15,284,60,224,1820,1747,73,0
2021,Exeter 005,E02004153,3244,1847,927,920,47,47,660,148,512,689,627,62,1
2021,Exeter 006,E02004154,3258,1715,836,879,33,33,336,79,257,1171,1086,85,3
2021,Exeter 007,E02004155,3266,1878,1036,842,16,16,983,883,100,374,311,63,15
2021,Exeter 008,E02004156,4862,1273,736,537,59,59,1366,499,867,2157,2036,121,7
2021,Exeter 009,E02004157,2929,1653,953,700,19,19,285,103,182,970,906,64,2
2021,Exeter 010,E02004158,3497,2104,984,1120,20,20,417,171,246,954,861,93,2
2021,Exeter 011,E02004159,5231,3657,1797,1860,121,121,508,158,350,943,874,69,2
2021,Exeter 012,E02004160,3082,2339,1394,945,10,10,394,205,189,334,285,49,5
2021,Exeter 013,E02004161,3529,1872,1006,866,34,34,1053,887,166,562,462,100,8
2021,Exeter 014,E02004162,3204,1940,1100,840,25,25,352,153,199,886,818,68,1
2021,Exeter 015,E02004163,3781,2612,1644,968,55,55,545,356,189,563,488,75,6
2021,Mid Devon 001,E02004164,2901,2183,1412,771,22,22,196,152,44,496,391,105,4
2021,Mid Devon 002,E02004165,3821,2842,1745,1097,20,20,172,36,136,787,702,85,0
2021,Mid Devon 003,E02004166,2848,2003,1225,778,46,46,364,198,166,430,342,88,5
2021,Mid Devon 004,E02004167,3065,1496,828,668,57,57,830,643,187,670,607,63,12
2021,Mid Devon 005,E02004168,2945,1486,826,660,13,13,702,463,239,738,669,69,6
2021,Mid Devon 006,E02004169,3094,2241,1272,969,28,28,327,207,120,495,418,77,3
2021,Mid Devon 007,E02004170,3799,2470,1261,1209,56,56,523,257,266,741,675,66,9
2021,Mid Devon 008,E02004171,3611,2634,1467,1167,43,43,373,229,144,559,451,108,2
2021,Mid Devon 009,E02004172,2717,2095,1314,781,4,4,220,157,63,397,314,83,1
2021,Mid Devon 010,E02004173,3124,2343,1434,909,18,18,261,214,47,498,392,106,4
2021,Mid Devon 011,E02004174,3708,2309,1329,980,57,57,537,276,261,801,743,58,4
2021,North Devon 001,E02004175,2446,1292,786,506,16,16,255,69,186,880,795,85,3
2021,North Devon 002,E02004176,2489,1836,1310,526,7,7,139,26,113,506,409,97,1
2021,North Devon 003,E02004177,2595,1676,1017,659,5,5,261,57,204,653,572,81,0
2021,North Devon 004,E02004178,2191,1767,1107,660,8,8,71,18,53,345,240,105,0
2021,North Devon 005,E02004179,3866,2625,1639,986,51,51,366,80,286,822,567,255,2
2021,North Devon 006,E02004180,2617,2036,1264,772,32,32,135,24,111,414,331,83,0
2021,North Devon 007,E02004181,2579,1717,996,721,33,33,402,87,315,425,377,48,2
2021,North Devon 008,E02004182,3037,1321,729,592,4,4,802,205,597,908,819,89,2
2021,North Devon 009,E02004183,2695,1932,1266,666,23,23,278,51,227,462,401,61,0
2021,North Devon 010,E02004184,3647,2094,1126,968,42,42,671,208,463,836,764,72,4
2021,North Devon 011,E02004185,2958,2342,1609,733,52,52,215,46,169,349,277,72,0
2021,North Devon 012,E02004186,4355,3110,1691,1419,120,120,424,80,344,701,597,104,0
2021,North Devon 013,E02004187,4614,3043,1975,1068,54,54,509,97,412,1005,842,163,3
2021,North Devon 014,E02004188,3100,2289,1540,749,29,29,281,61,220,500,369,131,1
2021,South Hams 001,E02004189,2609,1884,952,932,33,33,156,31,125,533,459,74,3
2021,South Hams 002,E02004190,3686,2702,1668,1034,66,66,387,41,346,529,415,114,2
2021,South Hams 003,E02004191,4336,2469,1698,771,113,113,887,111,776,865,759,106,2
2021,South Hams 004,E02004192,3407,2699,1865,834,46,46,192,21,171,470,370,100,0
2021,South Hams 005,E02004193,4981,3730,1975,1755,63,63,441,55,386,747,662,85,0
2021,South Hams 006,E02004194,3106,2179,1398,781,58,58,289,46,243,579,485,94,1
2021,South Hams 007,E02004195,2519,1502,1055,447,25,25,541,116,425,451,359,92,0
2021,South Hams 008,E02004196,3483,2490,1608,882,57,57,391,73,318,545,442,103,0
2021,South Hams 009,E02004197,3208,2497,1559,938,91,91,275,38,237,345,289,56,0
2021,South Hams 010,E02004198,2930,1801,1189,612,32,32,532,117,415,562,485,77,3
2021,South Hams 011,E02004199,2656,2040,1510,530,19,19,222,27,195,374,293,81,1
2021,South Hams 012,E02004200,2414,1721,1229,492,27,27,339,52,287,326,241,85,1
2021,Teignbridge 001,E02004201,2388,1913,1321,592,19,19,109,43,66,347,287,60,0
2021,Teignbridge 002,E02004202,3810,2727,1552,1175,48,48,343,66,277,692,612,80,0
2021,Teignbridge 003,E02004203,2570,1965,1352,613,14,14,181,45,136,410,325,85,0
2021,Teignbridge 004,E02004204,4409,3272,1941,1331,50,50,393,75,318,693,596,97,1
2021,Teignbridge 005,E02004205,3759,2728,1723,1005,69,69,331,51,280,630,559,71,1
2021,Teignbridge 006,E02004206,3330,2092,1487,605,66,66,384,98,286,788,708,80,0
2021,Teignbridge 007,E02004207,2961,2223,1365,858,41,41,276,58,218,418,368,50,3
2021,Teignbridge 008,E02004208,3717,3040,1930,1110,31,31,105,12,93,539,486,53,2
2021,Teignbridge 009,E02004209,3978,2806,1514,1292,69,69,447,83,364,656,563,93,0
2021,Teignbridge 010,E02004210,3255,1689,1054,635,24,24,540,145,395,1001,899,102,1
2021,Teignbridge 011,E02004211,2994,2486,1733,753,26,26,82,18,64,400,335,65,0
2021,Teignbridge 012,E02004212,2647,1882,1021,861,49,49,312,65,247,398,362,36,6
2021,Teignbridge 013,E02004213,3457,2583,1160,1423,114,114,218,28,190,540,475,65,2
2021,Teignbridge 014,E02004214,2966,1477,742,735,40,40,493,153,340,954,881,73,2
2021,Teignbridge 015,E02004215,2546,1576,887,689,16,16,410,70,340,543,488,55,1
2021,Teignbridge 016,E02004216,2419,1900,1151,749,8,8,257,98,159,253,215,38,1
2021,Teignbridge 017,E02004217,3522,2218,1407,811,36,36,488,141,347,774,663,111,6
2021,Teignbridge 018,E02004218,2694,2157,1320,837,39,39,178,32,146,320,278,42,0
2021,Teignbridge 019,E02004219,2405,1923,1228,695,13,13,138,42,96,331,260,71,0
2021,Torridge 001,E02004220,3008,2074,1415,659,28,28,331,65,266,574,487,87,1
2021,Torridge 002,E02004221,3032,2334,1652,682,27,27,98,12,86,573,513,60,0
2021,Torridge 003,E02004222,2784,1668,1019,649,18,18,268,28,240,830,739,91,0
2021,Torridge 004,E02004223,5611,3518,1903,1615,112,112,971,187,784,1006,883,123,4
2021,Torridge 005,E02004224,2776,1992,1336,656,15,15,173,26,147,596,440,156,0
2021,Torridge 006,E02004225,2521,1633,989,644,14,14,300,51,249,573,502,71,1
2021,Torridge 007,E02004226,3252,2496,1738,758,11,11,173,24,149,572,447,125,0
2021,Torridge 008,E02004227,4372,3038,2121,917,30,30,375,56,319,929,780,149,0
2021,Torridge 009,E02004228,3104,2433,1697,736,12,12,159,18,141,499,366,133,1
2021,West Devon 001,E02004229,4056,2862,1820,1042,58,58,351,53,298,785,648,137,0
2021,West Devon 002,E02004230,3512,2159,1341,818,14,14,463,66,397,875,789,86,1
2021,West Devon 003,E02004231,2913,2086,1400,686,14,14,280,63,217,532,444,88,1
2021,West Devon 004,E02004232,2891,2149,1438,711,10,10,138,43,95,594,472,122,0
2021,West Devon 005,E02004233,5831,4047,2684,1363,53,53,715,146,569,1012,895,117,4
2021,West Devon 006,E02004234,2713,2165,1459,706,9,9,230,60,170,308,250,58,1
2021,West Devon 007,E02004235,2903,2144,1427,717,18,18,318,64,254,421,333,88,2
2021,"Bournemouth, Christchurch and Poole 002",E02004236,2686,2064,1268,796,20,20,258,20,238,343,294,49,1
2021,"Bournemouth, Christchurch and Poole 014",E02004237,3291,2492,1432,1060,48,48,386,47,339,365,304,61,0
2021,"Bournemouth, Christchurch and Poole 019",E02004238,3727,2955,2129,826,23,23,279,64,215,469,416,53,1
2021,"Bournemouth, Christchurch and Poole 018",E02004239,2848,2443,1612,831,33,33,64,16,48,308,264,44,0
2021,"Bournemouth, Christchurch and Poole 024",E02004240,2653,1260,681,579,49,49,1057,122,935,286,256,30,1
2021,"Bournemouth, Christchurch and Poole 031",E02004241,4513,2797,1689,1108,48,48,655,53,602,1011,914,97,2
2021,"Bournemouth, Christchurch and Poole 033",E02004242,3115,2537,1854,683,9,9,149,13,136,420,359,61,0
2021,Dorset 007,E02004243,2692,1920,1143,777,7,7,258,31,227,507,429,78,0
2021,Dorset 010,E02004244,3292,2810,1566,1244,23,23,84,12,72,375,315,60,0
2021,Dorset 012,E02004245,3095,2382,1417,965,8,8,374,29,345,329,283,46,2
2021,Dorset 015,E02004246,3477,3062,2127,935,42,42,122,17,105,250,182,68,1
2021,Dorset 013,E02004247,2478,1725,1056,669,9,9,222,19,203,522,408,114,0
2021,Dorset 016,E02004248,3535,2919,2140,779,13,13,295,35,260,308,208,100,0
2021,Dorset 017,E02004249,2514,2072,1200,872,24,24,209,24,185,208,167,41,1
2021,Dorset 018,E02004250,3668,2691,1957,734,13,13,472,53,419,492,425,67,0
2021,Dorset 020,E02004251,2767,2374,1442,932,9,9,124,17,107,260,209,51,0
2021,Dorset 021,E02004252,3881,2252,1434,818,74,74,839,68,771,715,602,113,1
2021,Dorset 024,E02004253,4288,3752,2513,1239,37,37,119,11,108,380,313,67,0
2021,Dorset 025,E02004254,4299,3542,2026,1516,14,14,301,28,273,442,368,74,0
2021,Dorset 001,E02004255,3456,2394,1505,889,18,18,435,63,372,609,535,74,0
2021,Dorset 002,E02004256,3931,3014,1843,1171,50,50,243,21,222,624,521,103,0
2021,Dorset 003,E02004257,4136,2590,1563,1027,98,98,661,54,607,786,695,91,1
2021,Dorset 005,E02004258,4740,3330,2323,1007,34,34,664,68,596,712,578,134,0
2021,Dorset 006,E02004259,2863,2160,1484,676,17,17,333,31,302,353,271,82,0
2021,Dorset 009,E02004260,3265,2108,1313,795,24,24,404,29,375,727,381,346,2
2021,Dorset 011,E02004261,4767,3013,1664,1349,63,63,885,74,811,797,694,103,9
2021,Dorset 014,E02004262,3401,2475,1628,847,24,24,421,38,383,481,364,117,0
2021,Dorset 027,E02004263,2510,1757,1032,725,16,16,344,62,282,391,326,65,2
2021,Dorset 028,E02004264,3698,2805,1619,1186,48,48,302,49,253,543,476,67,0
2021,Dorset 033,E02004265,3853,2638,1807,831,27,27,626,102,524,561,490,71,1
2021,Dorset 035,E02004266,3333,2001,1252,749,31,31,510,75,435,789,438,351,2
2021,Dorset 039,E02004267,2239,1598,1187,411,17,17,229,15,214,395,308,87,0
2021,Dorset 042,E02004268,4513,3145,2293,852,28,28,547,67,480,791,658,133,2
2021,Dorset 004,E02004269,4697,2851,2039,812,43,43,895,61,834,908,765,143,0
2021,Dorset 008,E02004270,3438,2494,1713,781,40,40,304,23,281,597,474,123,3
2021,Dorset 019,E02004271,4587,3159,2277,882,36,36,551,36,515,839,656,183,2
2021,Dorset 022,E02004272,5342,3822,2450,1372,69,69,585,51,534,866,660,206,0
2021,Dorset 023,E02004273,3430,2473,1880,593,41,41,483,23,460,433,327,106,0
2021,Dorset 026,E02004274,3114,2071,1482,589,14,14,553,47,506,476,380,96,0
2021,Dorset 029,E02004275,3496,2569,1945,624,45,45,312,19,293,570,452,118,0
2021,Dorset 030,E02004276,2860,1831,1400,431,34,34,509,40,469,486,409,77,0
2021,Dorset 034,E02004278,3969,2829,1782,1047,25,25,538,29,509,577,524,53,0
2021,Dorset 036,E02004279,3514,2601,1672,929,35,35,355,17,338,523,403,120,0
2021,Dorset 037,E02004280,3729,2658,1692,966,64,64,428,36,392,579,470,109,0
2021,Dorset 038,E02004281,3482,2023,1074,949,32,32,816,163,653,609,529,80,2
2021,Dorset 040,E02004282,4109,3418,2451,967,44,44,142,12,130,505,441,64,0
2021,Dorset 041,E02004283,3848,2782,1739,1043,20,20,609,111,498,436,354,82,1
2021,Dorset 044,E02004284,5064,2412,1678,734,33,33,587,84,503,2029,1886,143,3
2021,Dorset 043,E02004285,3529,2224,1200,1024,37,37,599,111,488,667,613,54,2
2021,Dorset 045,E02004286,2175,1537,892,645,16,16,301,58,243,321,277,44,0
2021,Dorset 046,E02004287,2433,1693,1050,643,15,15,285,42,243,440,379,61,0
2021,Dorset 047,E02004288,2428,1294,813,481,40,40,476,85,391,617,570,47,1
2021,Dorset 048,E02004289,3293,2422,1456,966,24,24,257,50,207,590,513,77,0
2021,County Durham 002,E02004290,2588,2118,1170,948,11,11,182,66,116,277,238,39,0
2021,County Durham 005,E02004291,3354,2003,933,1070,8,8,741,290,451,600,532,68,2
2021,County Durham 007,E02004292,3675,2839,1644,1195,35,35,395,144,251,403,341,62,3
2021,County Durham 011,E02004293,4612,2178,1011,1167,35,35,1746,698,1048,648,566,82,5
2021,County Durham 013,E02004294,3654,3062,1806,1256,10,10,74,34,40,508,439,69,0
2021,County Durham 015,E02004295,3290,2254,1313,941,2,2,650,218,432,382,332,50,2
2021,County Durham 019,E02004296,3840,2345,1236,1109,12,12,919,358,561,561,502,59,3
2021,County Durham 001,E02004297,3607,2670,1371,1299,13,13,456,182,274,466,391,75,2
2021,County Durham 003,E02004298,4456,3349,1858,1491,7,7,544,207,337,556,464,92,0
2021,County Durham 004,E02004299,3743,2326,1300,1026,4,4,723,324,399,690,624,66,0
2021,County Durham 006,E02004300,3618,1915,1050,865,9,9,1061,456,605,632,574,58,1
2021,County Durham 008,E02004301,4280,2134,933,1201,3,3,1416,701,715,724,661,63,3
2021,County Durham 009,E02004302,3795,2114,1167,947,7,7,558,200,358,1114,1041,73,2
2021,County Durham 010,E02004303,5372,3406,1776,1630,23,23,623,170,453,1317,1170,147,3
2021,County Durham 012,E02004304,3930,2584,1326,1258,6,6,642,262,380,697,615,82,1
2021,County Durham 014,E02004305,4458,2806,1234,1572,7,7,1023,362,661,619,519,100,3
2021,County Durham 020,E02004306,2761,2066,1278,788,3,3,341,135,206,350,268,82,1
2021,County Durham 024,E02004307,2924,1914,1070,844,7,7,539,205,334,464,391,73,0
2021,County Durham 022,E02004308,3036,2533,1564,969,13,13,115,34,81,374,331,43,1
2021,County Durham 023,E02004309,2957,1858,1002,856,8,8,599,256,343,490,431,59,2
2021,County Durham 026,E02004310,3585,2220,1177,1043,6,6,884,473,411,467,415,52,8
2021,County Durham 027,E02004311,4251,2765,1447,1318,11,11,939,528,411,532,442,90,4
2021,County Durham 028,E02004312,3505,2869,1802,1067,8,8,178,93,85,449,380,69,1
2021,County Durham 029,E02004313,2967,1008,617,391,11,11,1159,372,787,786,731,55,3
2021,County Durham 030,E02004314,2370,671,460,211,7,7,374,115,259,1318,1247,71,0
2021,County Durham 033,E02004315,4730,3313,1713,1600,40,40,252,47,205,1125,1040,85,0
2021,County Durham 031,E02004316,3041,1790,960,830,10,10,743,303,440,484,409,75,14
2021,County Durham 038,E02004317,3539,1958,1093,865,5,5,1164,608,556,410,352,58,2
2021,County Durham 041,E02004318,3050,2015,1078,937,39,39,525,246,279,470,426,44,1
2021,County Durham 044,E02004319,3661,2396,1215,1181,7,7,768,391,377,490,398,92,0
2021,County Durham 016,E02004320,3788,2834,1483,1351,4,4,542,353,189,403,338,65,5
2021,County Durham 017,E02004321,3672,2266,1277,989,2,2,580,327,253,820,707,113,4
2021,County Durham 018,E02004322,3873,1708,897,811,5,5,1647,1093,554,500,417,83,13
2021,County Durham 021,E02004323,3364,2246,1186,1060,5,5,438,230,208,672,578,94,3
2021,County Durham 025,E02004324,2697,1757,978,779,2,2,410,132,278,526,456,70,2
2021,County Durham 032,E02004325,4063,1799,941,858,10,10,1518,1076,442,721,654,67,15
2021,County Durham 034,E02004326,3037,1757,935,822,8,8,825,373,452,439,359,80,8
2021,County Durham 036,E02004327,2770,1411,871,540,4,4,577,229,348,777,700,77,1
2021,County Durham 035,E02004328,3192,1811,928,883,14,14,813,555,258,546,506,40,8
2021,County Durham 037,E02004329,2867,1991,1173,818,2,2,541,349,192,327,285,42,6
2021,County Durham 039,E02004330,2899,1778,1109,669,10,10,545,240,305,564,495,69,2
2021,County Durham 040,E02004331,3258,1982,1059,923,6,6,775,441,334,489,425,64,6
2021,County Durham 043,E02004332,3257,2155,1124,1031,9,9,560,386,174,528,459,69,5
2021,County Durham 047,E02004333,3175,2305,1420,885,9,9,496,211,285,365,293,72,0
2021,County Durham 048,E02004334,3182,1971,1061,910,5,5,720,395,325,480,416,64,6
2021,County Durham 049,E02004335,3666,1864,841,1023,12,12,1007,417,590,775,685,90,8
2021,County Durham 050,E02004336,3307,1663,985,678,3,3,1008,481,527,632,556,76,1
2021,County Durham 052,E02004337,4789,2994,1444,1550,27,27,1013,441,572,754,678,76,1
2021,County Durham 053,E02004338,3497,2095,1048,1047,14,14,706,340,366,681,616,65,1
2021,County Durham 054,E02004339,3157,2385,1342,1043,15,15,321,133,188,434,349,85,2
2021,County Durham 059,E02004340,4930,2656,1488,1168,9,9,1170,583,587,1091,978,113,4
2021,County Durham 060,E02004341,3852,3047,1572,1475,5,5,353,151,202,447,378,69,0
2021,County Durham 061,E02004342,2404,785,387,398,6,6,1106,575,531,506,471,35,1
2021,County Durham 062,E02004343,2565,1456,735,721,19,19,740,403,337,347,302,45,3
2021,County Durham 063,E02004344,3236,1894,1116,778,2,2,875,477,398,459,399,60,6
2021,County Durham 064,E02004345,5847,4047,2620,1427,17,17,744,178,566,1037,835,202,2
2021,County Durham 042,E02004348,3753,2715,1809,906,7,7,421,152,269,608,477,131,2
2021,County Durham 045,E02004349,4169,2246,1252,994,6,6,1290,563,727,623,520,103,4
2021,County Durham 046,E02004350,4555,3230,1819,1411,9,9,384,165,219,931,798,133,1
2021,County Durham 051,E02004351,3261,1706,966,740,3,3,1084,581,503,463,397,66,5
2021,County Durham 055,E02004352,3896,2333,1263,1070,32,32,518,273,245,1010,933,77,3
2021,County Durham 056,E02004353,3296,2529,1531,998,5,5,147,45,102,615,530,85,0
2021,County Durham 057,E02004354,4019,2598,1403,1195,9,9,692,385,307,720,618,102,0
2021,County Durham 058,E02004355,3194,1523,817,706,2,2,1233,682,551,433,388,45,3
2021,Eastbourne 001,E02004356,2964,1693,883,810,51,51,719,508,211,493,435,58,8
2021,Eastbourne 002,E02004357,3017,1698,852,846,10,10,758,392,366,547,501,46,4
2021,Eastbourne 003,E02004358,3533,2278,1382,896,21,21,703,478,225,522,464,58,9
2021,Eastbourne 004,E02004359,3433,2155,1333,822,11,11,762,477,285,496,454,42,9
2021,Eastbourne 006,E02004361,3312,2465,1424,1041,6,6,443,378,65,396,354,42,2
2021,Eastbourne 007,E02004362,3611,2363,1164,1199,26,26,287,102,185,935,858,77,0
2021,Eastbourne 008,E02004363,3271,1829,1058,771,23,23,289,69,220,1129,1021,108,1
2021,Eastbourne 009,E02004364,3870,2543,1490,1053,15,15,429,188,241,879,799,80,4
2021,Eastbourne 010,E02004365,4018,1094,534,560,35,35,547,271,276,2337,2222,115,5
2021,Eastbourne 011,E02004366,4041,1815,1311,504,15,15,187,57,130,2017,1861,156,7
2021,Eastbourne 012,E02004367,3331,2538,1959,579,11,11,143,44,99,639,557,82,0
2021,Hastings 001,E02004368,3350,2431,1235,1196,20,20,266,47,219,633,540,93,0
2021,Hastings 002,E02004369,4340,3528,2270,1258,23,23,288,35,253,501,439,62,0
2021,Hastings 003,E02004370,3262,1361,597,764,15,15,1409,246,1163,476,424,52,1
2021,Hastings 004,E02004371,2970,1854,978,876,10,10,400,88,312,703,653,50,3
2021,Hastings 005,E02004372,2923,1192,587,605,24,24,1054,180,874,652,598,54,1
2021,Hastings 006,E02004373,3648,2327,1232,1095,29,29,513,79,434,778,701,77,1
2021,Hastings 007,E02004374,3325,2113,1238,875,5,5,266,39,227,939,832,107,2
2021,Hastings 008,E02004375,3912,2115,1154,961,23,23,264,31,233,1508,1421,87,2
2021,Hastings 009,E02004376,3578,1428,829,599,14,14,308,61,247,1826,1716,110,2
2021,Hastings 010,E02004377,4496,3021,1678,1343,34,34,376,40,336,1065,972,93,0
2021,Hastings 011,E02004378,4652,1521,848,673,8,8,629,75,554,2489,2345,144,5
2021,Lewes 001,E02004379,3126,2323,1265,1058,49,49,382,263,119,370,297,73,2
2021,Lewes 002,E02004380,3936,3096,1838,1258,70,70,316,201,115,450,359,91,4
2021,Lewes 003,E02004381,4390,2634,1567,1067,31,31,831,645,186,886,782,104,8
2021,Lewes 004,E02004382,2781,1822,1137,685,19,19,380,170,210,559,476,83,1
2021,Lewes 005,E02004383,3003,2190,1313,877,8,8,373,297,76,431,377,54,1
2021,Lewes 006,E02004384,3170,2466,1300,1166,13,13,199,101,98,489,426,63,3
2021,Lewes 007,E02004385,3421,2498,1474,1024,10,10,225,147,78,685,622,63,3
2021,Lewes 008,E02004386,2987,2051,1189,862,13,13,232,166,66,683,642,41,8
2021,Lewes 009,E02004387,2412,1332,579,753,16,16,471,365,106,589,546,43,4
2021,Lewes 010,E02004388,3373,2273,1240,1033,83,83,479,260,219,535,477,58,3
2021,Lewes 011,E02004389,4172,3553,2441,1112,22,22,143,79,64,452,392,60,2
2021,Lewes 012,E02004390,3538,2753,1838,915,16,16,442,317,125,322,265,57,5
2021,Lewes 013,E02004391,3381,2084,1345,739,59,59,303,153,150,932,864,68,3
2021,Rother 001,E02004392,3784,2851,1630,1221,60,60,428,61,367,445,352,93,0
2021,Rother 002,E02004393,2894,2128,1469,659,38,38,371,44,327,356,272,84,1
2021,Rother 003,E02004394,3303,2543,1563,980,24,24,308,46,262,428,329,99,0
2021,Rother 004,E02004395,3635,2365,1658,707,32,32,620,97,523,617,525,92,1
2021,Rother 005,E02004396,4016,3353,2295,1058,24,24,260,31,229,379,287,92,0
2021,Rother 006,E02004397,3396,2454,1553,901,13,13,363,72,291,566,493,73,0
2021,Rother 007,E02004398,3930,2100,1090,1010,62,62,1089,187,902,678,599,79,1
2021,Rother 008,E02004399,3688,2807,1913,894,27,27,229,21,208,625,557,68,0
2021,Rother 009,E02004400,4879,4298,3165,1133,48,48,127,20,107,406,341,65,0
2021,Rother 010,E02004401,3805,3101,2301,800,11,11,187,25,162,506,439,67,0
2021,Rother 011,E02004402,4778,2605,1758,847,34,34,315,43,272,1823,1668,155,1
2021,Wealden 001,E02004403,2678,1945,1183,762,0,0,250,184,66,482,385,97,1
2021,Wealden 002,E02004404,2628,2105,1165,940,12,12,149,82,67,360,278,82,2
2021,Wealden 003,E02004405,2488,2000,1201,799,53,53,136,31,105,299,263,36,0
2021,Wealden 004,E02004406,3096,2564,1561,1003,13,13,131,18,113,388,334,54,0
2021,Wealden 005,E02004407,3467,2666,1589,1077,23,23,277,144,133,501,407,94,0
2021,Wealden 006,E02004408,3354,2362,1157,1205,52,52,500,348,152,437,382,55,3
2021,Wealden 007,E02004409,2153,1790,1083,707,10,10,98,72,26,254,174,80,1
2021,Wealden 008,E02004410,3323,2705,1606,1099,34,34,213,144,69,368,282,86,3
2021,Wealden 009,E02004411,3704,2665,1488,1177,24,24,410,271,139,604,536,68,1
2021,Wealden 010,E02004412,3559,2699,1510,1189,41,41,248,173,75,571,517,54,0
2021,Wealden 011,E02004413,3093,2478,1420,1058,31,31,198,110,88,385,311,74,1
2021,Wealden 012,E02004414,2752,2034,997,1037,39,39,247,96,151,431,388,43,1
2021,Wealden 013,E02004415,2748,2134,1257,877,33,33,232,81,151,347,275,72,2
2021,Wealden 014,E02004416,2760,2227,1423,804,17,17,179,102,77,335,250,85,2
2021,Wealden 015,E02004417,2898,2203,1263,940,56,56,150,55,95,488,417,71,1
2021,Wealden 016,E02004418,2476,1747,1012,735,39,39,399,120,279,291,245,46,0
2021,Wealden 017,E02004419,2728,1616,913,703,60,60,713,445,268,336,290,46,3
2021,Wealden 018,E02004420,5893,4624,2771,1853,103,103,477,91,386,689,552,137,0
2021,Wealden 019,E02004421,4207,3139,1814,1325,75,75,332,139,193,659,560,99,2
2021,Wealden 020,E02004422,4772,3832,2119,1713,69,69,258,110,148,612,515,97,1
2021,Wealden 021,E02004423,3502,3014,1978,1036,11,11,108,73,35,368,296,72,1
2021,Basildon 001,E02004424,2734,2470,1326,1144,4,4,18,11,7,242,211,31,0
2021,Basildon 002,E02004425,3159,2398,1209,1189,11,11,299,209,90,448,407,41,3
2021,Basildon 003,E02004426,3352,2538,1266,1272,9,9,372,223,149,433,384,49,0
2021,Basildon 004,E02004427,3435,2870,1677,1193,8,8,229,206,23,327,271,56,1
2021,Basildon 005,E02004428,2962,2064,1050,1014,20,20,475,402,73,402,362,40,1
2021,Basildon 006,E02004429,3123,2680,1573,1107,16,16,164,117,47,260,212,48,3
2021,Basildon 007,E02004430,3298,2807,1353,1454,11,11,57,10,47,423,371,52,0
2021,Basildon 008,E02004431,4032,2799,1183,1616,67,67,391,177,214,770,708,62,5
2021,Basildon 009,E02004432,2559,2220,1233,987,7,7,75,54,21,257,222,35,0
2021,Basildon 010,E02004433,3666,2248,978,1270,26,26,841,415,426,547,495,52,4
2021,Basildon 011,E02004434,3515,2073,893,1180,207,207,680,523,157,548,494,54,7
2021,Basildon 012,E02004435,3815,2264,857,1407,41,41,1078,721,357,424,372,52,8
2021,Basildon 013,E02004436,3146,1117,490,627,37,37,1578,1250,328,410,354,56,4
2021,Basildon 014,E02004437,4288,2569,1123,1446,68,68,1181,862,319,460,403,57,10
2021,Basildon 015,E02004438,3887,1734,740,994,51,51,1412,1055,357,678,612,66,12
2021,Basildon 016,E02004439,3795,1407,584,823,51,51,1790,756,1034,538,508,30,9
2021,Basildon 017,E02004440,3650,2033,927,1106,34,34,856,690,166,725,670,55,2
2021,Basildon 018,E02004441,3283,1652,841,811,59,59,1184,880,304,375,339,36,13
2021,Basildon 019,E02004442,3303,1187,492,695,72,72,1649,585,1064,391,347,44,4
2021,Basildon 020,E02004443,4340,2484,1077,1407,26,26,673,512,161,1150,1051,99,7
2021,Basildon 021,E02004444,3567,2761,1291,1470,38,38,326,230,96,442,393,49,0
2021,Basildon 022,E02004445,3453,1924,870,1054,14,14,883,673,210,624,575,49,8
2021,Braintree 001,E02004446,2880,2206,1206,1000,10,10,352,67,285,312,245,67,0
2021,Braintree 002,E02004447,2588,1995,1228,767,13,13,235,39,196,345,279,66,0
2021,Braintree 003,E02004448,3278,2373,1178,1195,41,41,432,92,340,432,362,70,0
2021,Braintree 004,E02004449,3901,2256,1122,1134,22,22,880,219,661,735,662,73,8
2021,Braintree 005,E02004450,2672,1983,1146,837,15,15,315,62,253,358,248,110,1
2021,Braintree 006,E02004451,3985,2993,1639,1354,29,29,469,92,377,494,434,60,0
2021,Braintree 007,E02004452,3683,2961,1539,1422,4,4,290,54,236,428,377,51,0
2021,Braintree 008,E02004453,3094,1591,788,803,39,39,1100,283,817,359,314,45,5
2021,Braintree 009,E02004454,4379,2365,1182,1183,28,28,541,91,450,1445,1356,89,0
2021,Braintree 010,E02004455,3076,2539,1335,1204,25,25,205,24,181,307,264,43,0
2021,Braintree 011,E02004456,4157,2429,1104,1325,25,25,1005,211,794,694,620,74,4
2021,Braintree 012,E02004457,4160,2735,1218,1517,54,54,923,153,770,444,375,69,4
2021,Braintree 013,E02004458,3754,2949,1357,1592,30,30,278,38,240,497,433,64,0
2021,Braintree 014,E02004459,4432,3171,1731,1440,17,17,666,123,543,576,499,77,2
2021,Braintree 015,E02004460,4031,2793,1366,1427,48,48,792,177,615,398,333,65,0
2021,Braintree 016,E02004461,2240,1219,485,734,2,2,697,180,517,319,294,25,3
2021,Braintree 017,E02004462,5276,3149,1351,1798,54,54,941,191,750,1130,1034,96,2
2021,Braintree 018,E02004463,3397,2384,1288,1096,19,19,469,90,379,524,449,75,1
2021,Brentwood 001,E02004464,3830,3233,1834,1399,13,13,314,199,115,268,201,67,2
2021,Brentwood 002,E02004465,2779,2000,1155,845,34,34,316,263,53,422,364,58,7
2021,Brentwood 003,E02004466,3374,2339,1171,1168,10,10,615,548,67,404,356,48,6
2021,Brentwood 004,E02004467,3320,2138,949,1189,37,37,726,494,232,414,360,54,5
2021,Brentwood 005,E02004468,4200,3566,2012,1554,11,11,65,51,14,557,497,60,1
2021,Brentwood 006,E02004469,2889,2402,1144,1258,6,6,137,110,27,340,285,55,4
2021,Brentwood 007,E02004470,5718,3128,1325,1803,82,82,688,292,396,1803,1673,130,17
2021,Brentwood 008,E02004471,3644,2317,1079,1238,19,19,730,646,84,574,519,55,4
2021,Brentwood 009,E02004472,2588,2135,1128,1007,2,2,70,47,23,380,334,46,1
2021,Castle Point 001,E02004473,3125,2558,1344,1214,7,7,135,97,38,424,367,57,1
2021,Castle Point 002,E02004474,3305,2846,1580,1266,35,35,94,37,57,328,278,50,2
2021,Castle Point 003,E02004475,2645,2269,1251,1018,15,15,93,80,13,267,227,40,1
2021,Castle Point 004,E02004476,3222,2880,1554,1326,14,14,33,21,12,295,250,45,0
2021,Castle Point 005,E02004477,2636,2354,1460,894,8,8,48,29,19,225,184,41,1
2021,Castle Point 006,E02004478,2966,2046,1132,914,10,10,303,219,84,601,536,65,6
2021,Castle Point 007,E02004479,3315,2747,1503,1244,7,7,124,86,38,436,380,56,1
2021,Castle Point 008,E02004480,2691,2116,1038,1078,10,10,134,53,81,431,380,51,0
2021,Castle Point 009,E02004481,3190,2672,1814,858,8,8,82,68,14,427,372,55,1
2021,Castle Point 010,E02004482,3174,1934,960,974,9,9,690,512,178,533,480,53,8
2021,Castle Point 011,E02004483,3391,2669,1620,1049,10,10,139,96,43,573,507,66,0
2021,Castle Point 012,E02004484,3733,2846,1681,1165,4,4,178,125,53,702,627,75,3
2021,Chelmsford 001,E02004485,3883,2691,1204,1487,119,119,688,101,587,382,313,69,3
2021,Chelmsford 002,E02004486,3535,2793,1500,1293,24,24,313,29,284,405,352,53,0
2021,Chelmsford 003,E02004487,3049,1992,1045,947,31,31,690,145,545,334,277,57,2
2021,Chelmsford 004,E02004488,4114,3084,1461,1623,90,90,334,64,270,605,547,58,1
2021,Chelmsford 005,E02004489,3642,2720,1254,1466,42,42,492,46,446,387,332,55,1
2021,Chelmsford 006,E02004490,3273,1282,616,666,8,8,1538,293,1245,439,399,40,6
2021,Chelmsford 007,E02004491,3010,2417,1251,1166,13,13,102,14,88,476,426,50,2
2021,Chelmsford 008,E02004492,3961,2641,1136,1505,22,22,501,97,404,797,741,56,0
2021,Chelmsford 009,E02004493,4238,2451,1067,1384,43,43,850,149,701,891,829,62,3
2021,Chelmsford 011,E02004495,3534,2673,1624,1049,16,16,494,87,407,351,291,60,0
2021,Chelmsford 012,E02004496,3236,2584,1209,1375,42,42,146,26,120,464,416,48,0
2021,Chelmsford 013,E02004497,3368,2802,1614,1188,18,18,206,36,170,342,292,50,0
2021,Chelmsford 014,E02004498,4269,2528,1245,1283,43,43,1157,174,983,536,473,63,5
2021,Chelmsford 015,E02004499,2697,2317,1235,1082,16,16,108,11,97,256,229,27,0
2021,Chelmsford 016,E02004500,3736,3039,1722,1317,16,16,379,58,321,302,247,55,0
2021,Chelmsford 017,E02004501,2961,2221,1285,936,7,7,476,99,377,250,218,32,7
2021,Chelmsford 018,E02004502,2920,2375,1461,914,14,14,227,27,200,304,231,73,0
2021,Chelmsford 019,E02004503,3275,2643,1393,1250,31,31,83,6,77,517,455,62,1
2021,Chelmsford 020,E02004504,3318,2528,1189,1339,6,6,273,36,237,510,471,39,1
2021,Chelmsford 021,E02004505,2682,2239,1340,899,43,43,157,23,134,243,192,51,0
2021,Colchester 001,E02004506,2878,2327,1314,1013,9,9,244,153,91,298,237,61,0
2021,Colchester 002,E02004507,4133,2406,1012,1394,28,28,596,115,481,1101,1034,67,2
2021,Colchester 003,E02004508,2671,2146,1241,905,6,6,234,192,42,283,239,44,2
2021,Colchester 007,E02004512,5555,2550,1305,1245,28,28,616,211,405,2355,2200,155,6
2021,Colchester 008,E02004513,4297,1162,645,517,15,15,1687,1241,446,1425,1366,59,8
2021,Colchester 009,E02004514,2412,1855,1036,819,7,7,216,146,70,333,296,37,1
2021,Colchester 010,E02004515,3868,3109,1366,1743,35,35,322,127,195,401,343,58,1
2021,Colchester 011,E02004516,5609,2510,938,1572,23,23,879,198,681,2191,2061,130,6
2021,Colchester 012,E02004517,4011,2998,1465,1533,27,27,448,243,205,537,463,74,1
2021,Colchester 013,E02004518,3350,2140,973,1167,21,21,279,61,218,910,755,155,0
2021,Colchester 014,E02004519,3114,2611,1580,1031,4,4,197,132,65,301,255,46,1
2021,Colchester 015,E02004520,3462,1491,645,846,16,16,888,480,408,1058,455,603,9
2021,Colchester 016,E02004521,4229,2527,1205,1322,12,12,820,595,225,865,789,76,5
2021,Colchester 017,E02004522,3405,2629,1579,1050,20,20,152,92,60,603,522,81,1
2021,Colchester 018,E02004523,4154,2520,1049,1471,17,17,871,563,308,740,666,74,6
2021,Colchester 019,E02004524,3311,2817,1593,1224,9,9,172,127,45,311,244,67,2
2021,Colchester 020,E02004525,3538,2758,1676,1082,18,18,269,157,112,491,376,115,2
2021,Colchester 021,E02004526,3365,2734,1898,836,13,13,241,150,91,377,301,76,0
2021,Epping Forest 001,E02004527,3956,2798,1432,1366,35,35,465,301,164,654,588,66,4
2021,Epping Forest 002,E02004528,3497,2847,1584,1263,8,8,285,237,48,354,248,106,3
2021,Epping Forest 003,E02004529,2837,2129,1180,949,18,18,279,233,46,411,314,97,0
2021,Epping Forest 004,E02004530,2923,2073,1132,941,33,33,482,372,110,326,272,54,9
2021,Epping Forest 005,E02004531,2923,2028,1014,1014,21,21,527,373,154,342,294,48,5
2021,Epping Forest 006,E02004532,2817,1885,982,903,9,9,370,252,118,549,509,40,4
2021,Epping Forest 007,E02004533,3105,1827,897,930,39,39,941,738,203,290,259,31,8
2021,Epping Forest 008,E02004534,3680,2376,1021,1355,18,18,759,621,138,522,460,62,5
2021,Epping Forest 009,E02004535,2726,1834,1116,718,56,56,291,135,156,540,460,80,5
2021,Epping Forest 010,E02004536,2531,1986,1126,860,7,7,271,199,72,267,220,47,0
2021,Epping Forest 011,E02004537,3995,2015,829,1186,12,12,1302,1139,163,649,583,66,17
2021,Epping Forest 012,E02004538,3826,2924,1414,1510,26,26,211,149,62,663,604,59,2
2021,Epping Forest 013,E02004539,3214,2118,980,1138,8,8,647,610,37,435,383,52,6
2021,Epping Forest 014,E02004540,2435,1864,921,943,6,6,199,145,54,364,317,47,2
2021,Epping Forest 015,E02004541,4875,3520,1727,1793,15,15,386,291,95,952,856,96,2
2021,Epping Forest 016,E02004542,2548,2077,1011,1066,5,5,118,89,29,345,275,70,3
2021,Epping Forest 017,E02004543,2669,1686,816,870,34,34,462,329,133,483,440,43,4
2021,Harlow 001,E02004544,4634,2980,1061,1919,197,197,883,601,282,570,507,63,4
2021,Harlow 002,E02004545,3218,1413,625,788,25,25,1310,1187,123,458,417,41,12
2021,Harlow 003,E02004546,3551,1547,675,872,21,21,1282,1166,116,685,636,49,16
2021,Harlow 004,E02004547,3905,1719,701,1018,83,83,1351,1074,277,744,684,60,8
2021,Harlow 005,E02004548,3480,2675,997,1678,16,16,174,33,141,613,558,55,2
2021,Harlow 006,E02004549,3220,1676,772,904,7,7,1151,1116,35,381,333,48,5
2021,Harlow 007,E02004550,3742,1553,734,819,27,27,1342,1010,332,806,753,53,14
2021,Harlow 008,E02004551,3177,1647,739,908,18,18,1136,1031,105,364,322,42,12
2021,Harlow 009,E02004552,2777,1792,907,885,7,7,623,529,94,348,316,32,7
2021,Harlow 010,E02004553,3089,1629,699,930,78,78,1008,588,420,370,337,33,4
2021,Harlow 011,E02004554,3062,1715,814,901,20,20,836,718,118,483,435,48,8
2021,Maldon 001,E02004555,2634,2085,1272,813,15,15,251,33,218,283,221,62,0
2021,Maldon 002,E02004556,3043,2579,1564,1015,10,10,204,28,176,250,191,59,0
2021,Maldon 003,E02004557,3682,2740,1383,1357,50,50,510,35,475,380,312,68,2
2021,Maldon 004,E02004558,3317,1969,1274,695,32,32,657,50,607,659,574,85,0
2021,Maldon 005,E02004559,3372,2692,1532,1160,40,40,338,28,310,302,249,53,0
2021,Maldon 006,E02004560,3678,2812,1514,1298,17,17,393,34,359,455,366,89,1
2021,Maldon 007,E02004561,4203,3502,2010,1492,15,15,284,20,264,402,303,99,0
2021,Maldon 008,E02004562,3966,2874,1670,1204,49,49,496,39,457,546,452,94,1
2021,Rochford 001,E02004563,2908,2593,1699,894,7,7,83,10,73,225,178,47,0
2021,Rochford 002,E02004564,3244,2872,1612,1260,22,22,99,16,83,251,206,45,0
2021,Rochford 004,E02004566,2417,1307,613,694,24,24,707,73,634,376,318,58,3
2021,Rochford 005,E02004567,3260,2893,1611,1282,6,6,65,7,58,296,257,39,0
2021,Rochford 006,E02004568,3589,2730,1202,1528,18,18,401,51,350,440,386,54,0
2021,Rochford 007,E02004569,3735,2746,1346,1400,52,52,346,33,313,591,518,73,0
2021,Rochford 008,E02004570,3696,2756,1561,1195,15,15,469,52,417,456,400,56,0
2021,Rochford 009,E02004571,3182,2879,1681,1198,8,8,55,15,40,240,197,43,0
2021,Rochford 010,E02004572,3250,2461,1250,1211,28,28,369,73,296,392,292,100,0
2021,Tendring 001,E02004573,3054,1541,906,635,10,10,400,242,158,1099,1036,63,4
2021,Tendring 002,E02004574,3398,2072,1133,939,19,19,606,307,299,694,626,68,7
2021,Tendring 003,E02004575,5327,3935,2221,1714,20,20,489,360,129,877,750,127,6
2021,Tendring 004,E02004576,3906,3204,1975,1229,11,11,209,146,63,479,405,74,3
2021,Tendring 005,E02004577,2439,1981,1036,945,18,18,168,95,73,270,206,64,2
2021,Tendring 006,E02004578,3767,2533,1859,674,25,25,318,134,184,889,761,128,2
2021,Tendring 007,E02004579,3471,2959,1878,1081,16,16,148,115,33,348,264,84,0
2021,Tendring 008,E02004580,5785,4696,3440,1256,48,48,276,108,168,764,647,117,1
2021,Tendring 009,E02004581,3533,2984,1798,1186,43,43,132,78,54,373,299,74,1
2021,Tendring 010,E02004582,3306,2682,1887,795,12,12,180,22,158,432,362,70,0
2021,Tendring 011,E02004583,4081,3018,1885,1133,13,13,218,125,93,829,754,75,3
2021,Tendring 012,E02004584,3287,2821,2199,622,8,8,58,26,32,400,310,90,0
2021,Tendring 013,E02004585,3849,2876,1781,1095,12,12,343,71,272,618,542,76,0
2021,Tendring 014,E02004586,3789,2524,1731,793,11,11,286,93,193,967,872,95,1
2021,Tendring 015,E02004587,3391,1903,1232,671,13,13,801,435,366,668,609,59,6
2021,Tendring 016,E02004588,3487,1391,876,515,11,11,393,144,249,1689,1619,70,3
2021,Tendring 017,E02004589,3267,2215,1480,735,14,14,242,130,112,796,719,77,0
2021,Tendring 018,E02004590,4321,2879,2193,686,13,13,240,71,169,1187,1054,133,2
2021,Uttlesford 001,E02004591,3094,2324,1274,1050,69,69,280,156,124,420,365,55,1
2021,Uttlesford 002,E02004592,5813,3615,1996,1619,86,86,1060,524,536,1046,926,120,6
2021,Uttlesford 003,E02004593,3666,2694,1472,1222,56,56,467,301,166,447,362,85,2
2021,Uttlesford 004,E02004594,3288,2274,1221,1053,63,63,427,276,151,524,326,198,0
2021,Uttlesford 005,E02004595,5950,4433,2051,2382,125,125,613,279,334,777,686,91,2
2021,Uttlesford 006,E02004596,4005,2801,1195,1606,93,93,549,270,279,562,491,71,0
2021,Uttlesford 007,E02004597,3855,2539,1234,1305,81,81,618,323,295,611,541,70,6
2021,Uttlesford 008,E02004598,4250,3193,1600,1593,56,56,432,261,171,563,469,94,6
2021,Uttlesford 009,E02004599,3034,2213,1134,1079,30,30,363,290,73,426,352,74,2
2021,Cheltenham 001,E02004600,2480,1747,991,756,12,12,265,206,59,451,405,46,5
2021,Cheltenham 002,E02004601,2628,2182,1374,808,25,25,161,71,90,260,228,32,0
2021,Cheltenham 003,E02004602,2841,1427,663,764,44,44,835,458,377,528,487,41,7
2021,Cheltenham 004,E02004603,3347,1342,699,643,44,44,617,323,294,1337,1266,71,7
2021,Cheltenham 005,E02004604,3514,1438,663,775,46,46,1471,1147,324,547,480,67,12
2021,Cheltenham 006,E02004605,2467,1288,610,678,9,9,827,683,144,328,294,34,15
2021,Cheltenham 007,E02004606,4627,2713,1187,1526,53,53,580,410,170,1275,1176,99,6
2021,Cheltenham 008,E02004607,4984,2707,1334,1373,46,46,303,149,154,1928,1810,118,0
2021,Cheltenham 009,E02004608,5068,2346,1368,978,21,21,364,86,278,2336,2206,130,1
2021,Cheltenham 010,E02004609,3115,2423,1416,1007,26,26,111,54,57,554,511,43,1
2021,Cheltenham 011,E02004610,3609,2569,1617,952,8,8,173,56,117,859,779,80,0
2021,Cheltenham 012,E02004611,4927,3905,1870,2035,27,27,287,181,106,706,626,80,2
2021,Cheltenham 013,E02004612,4181,3268,1979,1289,30,30,250,177,73,629,572,57,4
2021,Cheltenham 014,E02004613,2763,2312,1411,901,4,4,94,16,78,353,315,38,0
2021,Cheltenham 015,E02004614,2357,1969,1183,786,4,4,95,53,42,289,251,38,0
2021,Cotswold 001,E02004615,4013,2743,1771,972,107,107,649,76,573,513,398,115,1
2021,Cotswold 002,E02004616,4746,3019,1925,1094,108,108,790,88,702,827,640,187,2
2021,Cotswold 003,E02004617,4121,2699,1579,1120,117,117,537,43,494,768,606,162,0
2021,Cotswold 004,E02004618,3098,2156,1315,841,16,16,237,31,206,689,518,171,0
2021,Cotswold 005,E02004619,3215,2090,1340,750,15,15,402,33,369,707,511,196,1
2021,Cotswold 006,E02004620,3530,2474,1396,1078,115,115,570,65,505,371,320,51,0
2021,Cotswold 007,E02004621,3159,1599,1092,507,27,27,727,65,662,803,720,83,3
2021,Cotswold 008,E02004622,3235,1799,1055,744,72,72,674,93,581,689,524,165,1
2021,Cotswold 009,E02004623,4076,2875,1758,1117,102,102,612,60,552,486,387,99,1
2021,Cotswold 010,E02004624,2768,1949,1156,793,90,90,335,23,312,394,329,65,0
2021,Cotswold 011,E02004625,4633,3033,1789,1244,101,101,697,95,602,801,639,162,1
2021,Forest of Dean 001,E02004626,3799,3036,1953,1083,39,39,243,36,207,480,362,118,1
2021,Forest of Dean 002,E02004627,2829,1837,1134,703,42,42,432,81,351,517,438,79,1
2021,Forest of Dean 003,E02004628,3321,2535,1517,1018,41,41,430,85,345,314,253,61,1
2021,Forest of Dean 004,E02004629,5734,3807,2191,1616,22,22,975,157,818,927,790,137,3
2021,Forest of Dean 005,E02004630,2745,2147,1348,799,16,16,191,33,158,390,297,93,1
2021,Forest of Dean 006,E02004631,2237,1850,1194,656,6,6,150,21,129,230,170,60,1
2021,Forest of Dean 007,E02004632,4864,3281,2007,1274,34,34,874,151,723,671,588,83,4
2021,Forest of Dean 008,E02004633,3600,2739,1652,1087,29,29,465,78,387,367,296,71,0
2021,Forest of Dean 009,E02004634,5024,3454,2034,1420,59,59,775,132,643,736,626,110,0
2021,Forest of Dean 010,E02004635,3060,2332,1436,896,31,31,300,57,243,396,249,147,1
2021,Gloucester 001,E02004636,3289,2795,1581,1214,8,8,66,21,45,420,353,67,0
2021,Gloucester 002,E02004637,4135,2251,1237,1014,34,34,567,156,411,1281,1180,101,2
2021,Gloucester 003,E02004638,2369,1917,977,940,8,8,135,71,64,307,277,30,2
2021,Gloucester 004,E02004639,5556,2146,1022,1124,123,123,1019,215,804,2262,2113,149,6
2021,Gloucester 005,E02004640,3239,1477,795,682,18,18,451,116,335,1288,1194,94,5
2021,Gloucester 006,E02004641,3341,2766,1706,1060,14,14,184,79,105,376,325,51,1
2021,Gloucester 007,E02004642,4783,3465,1654,1811,37,37,582,281,301,695,615,80,4
2021,Gloucester 008,E02004643,3170,1512,690,822,27,27,785,316,469,837,760,77,9
2021,Gloucester 009,E02004644,3772,2310,1035,1275,13,13,682,286,396,761,682,79,6
2021,Gloucester 010,E02004645,3904,3171,1608,1563,20,20,113,25,88,598,535,63,2
2021,Gloucester 011,E02004646,3977,2146,1047,1099,21,21,1342,777,565,454,402,52,14
2021,Gloucester 012,E02004647,2533,1676,916,760,34,34,571,293,278,248,199,49,4
2021,Gloucester 013,E02004648,2557,2002,1202,800,15,15,139,73,66,401,350,51,0
2021,Gloucester 014,E02004649,3004,2127,840,1287,25,25,141,10,131,710,653,57,1
2021,Gloucester 015,E02004650,5772,3615,1197,2418,232,232,758,74,684,1165,1053,112,2
2021,Stroud 001,E02004651,4514,3280,1394,1886,114,114,417,168,249,700,625,75,3
2021,Stroud 002,E02004652,2922,2351,1564,787,16,16,166,120,46,386,305,81,3
2021,Stroud 003,E02004653,3163,2414,1334,1080,78,78,335,188,147,329,260,69,7
2021,Stroud 004,E02004654,4974,3451,1927,1524,34,34,807,626,181,674,597,77,8
2021,Stroud 005,E02004655,3437,2286,1231,1055,43,43,613,487,126,489,419,70,6
2021,Stroud 006,E02004656,5360,3325,1916,1409,59,59,892,540,352,1078,957,121,6
2021,Stroud 007,E02004657,2935,2388,1344,1044,14,14,156,99,57,375,312,63,2
2021,Stroud 008,E02004658,2706,2250,1228,1022,9,9,92,80,12,353,302,51,2
2021,Stroud 009,E02004659,3023,2318,1418,900,48,48,389,286,103,262,224,38,6
2021,Stroud 010,E02004660,2913,2298,1519,779,18,18,316,247,69,276,222,54,5
2021,Stroud 011,E02004661,3824,2831,1659,1172,57,57,568,463,105,359,301,58,9
2021,Stroud 012,E02004662,2798,1997,1102,895,38,38,312,225,87,446,375,71,5
2021,Stroud 013,E02004663,2880,2028,1198,830,21,21,391,248,143,435,380,55,5
2021,Stroud 014,E02004664,3251,2158,1108,1050,44,44,562,424,138,479,420,59,8
2021,Stroud 015,E02004665,3675,2708,1606,1102,37,37,411,321,90,510,428,82,9
2021,Tewkesbury 001,E02004666,5002,3481,1612,1869,104,104,562,79,483,855,714,141,0
2021,Tewkesbury 002,E02004667,5084,3233,2007,1226,74,74,963,168,795,812,700,112,2
2021,Tewkesbury 003,E02004668,4129,3014,2007,1007,104,104,490,60,430,519,423,96,2
2021,Tewkesbury 004,E02004669,3112,2499,1515,984,49,49,213,24,189,351,273,78,0
2021,Tewkesbury 006,E02004671,3007,2320,1318,1002,66,66,231,49,182,388,324,64,2
2021,Tewkesbury 007,E02004672,5316,3745,2114,1631,20,20,564,101,463,986,683,303,1
2021,Tewkesbury 008,E02004673,3254,2333,1276,1057,103,103,491,100,391,325,240,85,2
2021,Tewkesbury 009,E02004674,5068,3435,1537,1898,111,111,836,191,645,682,593,89,4
2021,Basingstoke and Deane 001,E02004675,3220,2377,1265,1112,50,50,498,26,472,294,243,51,1
2021,Basingstoke and Deane 002,E02004676,3403,2730,1501,1229,12,12,264,15,249,397,340,57,0
2021,Basingstoke and Deane 003,E02004677,2912,2071,1143,928,49,49,387,33,354,405,274,131,0
2021,Basingstoke and Deane 004,E02004678,3227,2383,1311,1072,22,22,387,26,361,433,319,114,2
2021,Basingstoke and Deane 005,E02004679,4481,3127,1323,1804,174,174,708,42,666,472,383,89,0
2021,Basingstoke and Deane 006,E02004680,3317,2416,927,1489,47,47,200,6,194,653,613,40,1
2021,Basingstoke and Deane 007,E02004681,5781,2771,883,1888,288,288,1813,103,1710,905,840,65,4
2021,Basingstoke and Deane 008,E02004682,3389,2191,968,1223,80,80,594,37,557,523,486,37,1
2021,Basingstoke and Deane 009,E02004683,3419,1680,670,1010,112,112,1086,73,1013,541,483,58,0
2021,Basingstoke and Deane 010,E02004684,4597,2736,957,1779,121,121,1071,38,1033,669,602,67,0
2021,Basingstoke and Deane 011,E02004685,3782,1691,795,896,88,88,644,36,608,1358,1284,74,1
2021,Basingstoke and Deane 012,E02004686,3857,1961,907,1054,47,47,594,33,561,1254,1181,73,1
2021,Basingstoke and Deane 013,E02004687,2880,1554,643,911,32,32,958,49,909,335,296,39,1
2021,Basingstoke and Deane 014,E02004688,3413,1659,818,841,25,25,1342,82,1260,387,335,52,0
2021,Basingstoke and Deane 015,E02004689,2380,1950,1144,806,25,25,180,7,173,224,191,33,1
2021,Basingstoke and Deane 016,E02004690,3341,2418,1146,1272,30,30,314,6,308,579,531,48,0
2021,Basingstoke and Deane 017,E02004691,3342,2473,1467,1006,48,48,323,20,303,498,384,114,0
2021,Basingstoke and Deane 018,E02004692,3018,2762,1687,1075,2,2,122,5,117,132,110,22,0
2021,Basingstoke and Deane 019,E02004693,3188,1736,719,1017,38,38,955,46,909,459,429,30,0
2021,Basingstoke and Deane 020,E02004694,3189,2179,1154,1025,54,54,502,36,466,454,367,87,0
2021,Basingstoke and Deane 021,E02004695,3328,2593,917,1676,26,26,252,8,244,457,419,38,0
2021,Basingstoke and Deane 022,E02004696,3188,2186,1130,1056,104,104,519,40,479,377,304,73,2
2021,East Hampshire 001,E02004697,2669,1997,1075,922,35,35,204,18,186,433,347,86,0
2021,East Hampshire 002,E02004698,2974,1369,708,661,46,46,1077,164,913,482,430,52,0
2021,East Hampshire 003,E02004699,4708,3563,2079,1484,64,64,436,54,382,644,546,98,1
2021,East Hampshire 004,E02004700,2756,1571,475,1096,102,102,628,90,538,454,371,83,1
2021,East Hampshire 006,E02004702,3322,2389,1117,1272,27,27,489,90,399,416,364,52,1
2021,East Hampshire 007,E02004703,5025,4021,2241,1780,99,99,366,31,335,539,418,121,0
2021,East Hampshire 008,E02004704,2591,1951,1054,897,28,28,273,43,230,338,238,100,1
2021,East Hampshire 009,E02004705,4052,3002,1586,1416,69,69,494,68,426,487,411,76,0
2021,East Hampshire 010,E02004706,3112,2336,1321,1015,11,11,344,49,295,420,345,75,1
2021,East Hampshire 011,E02004707,4648,3475,2120,1355,38,38,421,45,376,714,543,171,0
2021,East Hampshire 012,E02004708,4360,2619,1530,1089,83,83,833,119,714,825,747,78,0
2021,East Hampshire 013,E02004709,3585,2927,1586,1341,56,56,321,44,277,281,232,49,0
2021,East Hampshire 014,E02004710,2703,2145,1155,990,5,5,325,39,286,228,196,32,0
2021,Eastleigh 001,E02004712,3413,2965,1687,1278,14,14,58,2,56,376,337,39,0
2021,Eastleigh 002,E02004713,3267,2724,1459,1265,26,26,195,11,184,321,276,45,1
2021,Eastleigh 003,E02004714,3333,2678,1562,1116,22,22,149,10,139,484,428,56,0
2021,Eastleigh 004,E02004715,3871,2534,1232,1302,75,75,681,72,609,580,526,54,1
2021,Eastleigh 005,E02004716,3603,2617,1336,1281,55,55,560,44,516,370,311,59,1
2021,Eastleigh 006,E02004717,5224,2536,970,1566,299,299,1688,166,1522,701,631,70,0
2021,Eastleigh 007,E02004718,3834,1980,883,1097,50,50,744,70,674,1059,981,78,1
2021,Eastleigh 008,E02004719,4617,3825,1818,2007,107,107,264,29,235,420,366,54,1
2021,Eastleigh 009,E02004720,5036,3817,2075,1742,81,81,420,38,382,718,641,77,0
2021,Eastleigh 010,E02004721,4454,3161,1091,2070,183,183,415,27,388,695,633,62,0
2021,Eastleigh 011,E02004722,3060,2141,1188,953,16,16,515,55,460,387,336,51,1
2021,Eastleigh 012,E02004723,4080,3418,1825,1593,49,49,136,14,122,477,422,55,0
2021,Eastleigh 013,E02004724,3976,2597,1093,1504,109,109,769,60,709,501,439,62,0
2021,Eastleigh 014,E02004725,2443,1515,795,720,29,29,511,41,470,388,333,55,0
2021,Eastleigh 015,E02004726,2702,1880,998,882,42,42,321,30,291,459,421,38,0
2021,Fareham 001,E02004727,3859,3098,1286,1812,49,49,247,55,192,465,408,57,0
2021,Fareham 002,E02004728,3810,2688,1339,1349,71,71,427,172,255,620,539,81,4
2021,Fareham 003,E02004729,3071,2135,1131,1004,12,12,592,418,174,323,270,53,9
2021,Fareham 004,E02004730,3597,3149,1813,1336,9,9,125,16,109,314,274,40,0
2021,Fareham 005,E02004731,3270,2696,1510,1186,9,9,120,52,68,443,394,49,2
2021,Fareham 006,E02004732,3715,3067,1677,1390,20,20,196,116,80,428,363,65,4
2021,Fareham 007,E02004733,3429,2581,1362,1219,72,72,333,178,155,441,344,97,2
2021,Fareham 008,E02004734,4493,3383,1812,1571,17,17,328,132,196,764,672,92,1
2021,Fareham 009,E02004735,3261,2753,1723,1030,6,6,45,27,18,457,271,186,0
2021,Fareham 010,E02004736,3525,3106,1817,1289,22,22,123,73,50,273,218,55,1
2021,Fareham 011,E02004737,3376,1990,935,1055,25,25,765,525,240,588,510,78,8
2021,Fareham 012,E02004738,3168,2530,1452,1078,4,4,314,259,55,314,242,72,6
2021,Fareham 013,E02004739,2927,2403,1597,806,15,15,244,192,52,264,222,42,1
2021,Fareham 014,E02004740,3135,2609,1697,912,10,10,103,26,77,413,264,149,0
2021,Gosport 001,E02004741,3151,2176,1180,996,27,27,687,438,249,250,212,38,11
2021,Gosport 002,E02004742,3148,1987,1062,925,9,9,758,550,208,377,304,73,17
2021,Gosport 003,E02004743,3101,2388,1182,1206,17,17,209,143,66,485,400,85,2
2021,Gosport 004,E02004744,3797,1586,622,964,87,87,1035,226,809,1086,720,366,3
2021,Gosport 005,E02004745,3808,2088,949,1139,75,75,727,404,323,913,830,83,5
2021,Gosport 006,E02004746,4865,3637,2167,1470,112,112,432,131,301,683,499,184,1
2021,Gosport 007,E02004747,2858,1831,975,856,29,29,335,220,115,659,535,124,4
2021,Gosport 008,E02004748,4796,2032,1105,927,66,66,1350,753,597,1330,1207,123,18
2021,Gosport 009,E02004749,3046,2597,1642,955,3,3,96,30,66,349,270,79,1
2021,Gosport 010,E02004750,3356,2525,1428,1097,9,9,236,104,132,584,505,79,2
2021,Hart 001,E02004751,3534,2740,1466,1274,42,42,412,43,369,340,279,61,0
2021,Hart 002,E02004752,3198,2778,1430,1348,18,18,111,11,100,291,232,59,0
2021,Hart 003,E02004753,4302,3384,1699,1685,107,107,313,36,277,498,431,67,0
2021,Hart 004,E02004754,3085,2153,1148,1005,55,55,436,55,381,439,372,67,2
2021,Hart 005,E02004755,5152,3454,1455,1999,138,138,289,32,257,1270,1160,110,1
2021,Hart 006,E02004756,3883,2896,1300,1596,109,109,376,39,337,502,446,56,0
2021,Hart 007,E02004757,3165,2868,1652,1216,11,11,94,11,83,192,168,24,0
2021,Hart 008,E02004758,3729,2746,1337,1409,76,76,528,52,476,379,329,50,0
2021,Hart 009,E02004759,3311,2808,1402,1406,16,16,150,7,143,336,291,45,1
2021,Hart 010,E02004760,4059,2872,1176,1696,140,140,419,43,376,627,441,186,1
2021,Hart 011,E02004761,2547,1562,892,670,29,29,384,39,345,572,280,292,0
2021,Havant 003,E02004764,3659,2906,1832,1074,44,44,419,90,329,287,247,40,3
2021,Havant 004,E02004765,2709,2165,1197,968,9,9,60,21,39,475,433,42,0
2021,Havant 005,E02004766,2979,1704,840,864,42,42,887,147,740,343,305,38,3
2021,Havant 006,E02004767,2265,1086,505,581,19,19,882,680,202,267,234,33,11
2021,Havant 007,E02004768,2253,1353,669,684,8,8,521,70,451,370,330,40,1
2021,Havant 008,E02004769,2488,1004,441,563,28,28,1136,926,210,305,265,40,15
2021,Havant 009,E02004770,2819,1332,602,730,14,14,1141,799,342,319,279,40,13
2021,Havant 010,E02004771,3659,1755,805,950,32,32,1397,941,456,465,389,76,10
2021,Havant 011,E02004772,3991,3165,1664,1501,31,31,429,361,68,358,297,61,8
2021,Havant 013,E02004774,4676,3502,2330,1172,49,49,500,82,418,623,503,120,2
2021,Havant 014,E02004775,4618,3274,1907,1367,59,59,615,90,525,668,608,60,2
2021,Havant 015,E02004776,2634,2185,1476,709,13,13,183,31,152,253,208,45,0
2021,Havant 016,E02004777,2599,1823,1284,539,10,10,318,54,264,447,391,56,1
2021,Havant 017,E02004778,2957,2283,1592,691,21,21,142,32,110,511,451,60,0
2021,New Forest 001,E02004779,4865,3522,2243,1279,17,17,505,280,225,817,658,159,4
2021,New Forest 002,E02004780,2504,1687,943,744,10,10,491,406,85,308,268,40,8
2021,New Forest 003,E02004781,3334,2503,1230,1273,27,27,268,75,193,536,485,51,0
2021,New Forest 004,E02004782,3454,2356,1289,1067,31,31,529,278,251,538,472,66,0
2021,New Forest 005,E02004783,2986,2331,1154,1177,7,7,257,141,116,391,345,46,0
2021,New Forest 006,E02004784,2279,1995,1269,726,2,2,88,44,44,194,151,43,0
2021,New Forest 007,E02004785,2407,1864,1228,636,7,7,173,106,67,363,276,87,0
2021,New Forest 008,E02004786,3515,2438,1268,1170,26,26,394,140,254,657,477,180,0
2021,New Forest 009,E02004787,3452,2780,1824,956,14,14,192,92,100,463,397,66,3
2021,New Forest 010,E02004788,2898,2401,1432,969,15,15,134,73,61,347,278,69,1
2021,New Forest 011,E02004789,4377,3050,1776,1274,35,35,853,513,340,434,324,110,5
2021,New Forest 012,E02004790,3693,2333,1351,982,60,60,515,354,161,781,692,89,4
2021,New Forest 013,E02004791,2228,1332,712,620,16,16,649,276,373,228,187,41,3
2021,New Forest 014,E02004792,3746,2958,1866,1092,33,33,279,121,158,475,383,92,1
2021,New Forest 015,E02004793,3100,2508,1713,795,15,15,221,133,88,353,282,71,3
2021,New Forest 016,E02004794,2880,2321,1451,870,25,25,195,130,65,339,265,74,0
2021,New Forest 017,E02004795,4071,2712,1955,757,19,19,361,250,111,976,794,182,3
2021,New Forest 018,E02004796,4312,3730,2562,1168,19,19,161,57,104,401,317,84,1
2021,New Forest 019,E02004797,3666,2251,1367,884,45,45,768,631,137,591,535,56,11
2021,New Forest 020,E02004798,2675,1569,945,624,24,24,763,565,198,315,273,42,4
2021,New Forest 021,E02004799,3832,2648,1790,858,25,25,365,186,179,794,713,81,0
2021,New Forest 022,E02004800,3545,3108,2411,697,12,12,58,19,39,367,314,53,0
2021,New Forest 023,E02004801,3746,3119,2369,750,21,21,145,104,41,460,379,81,1
2021,Rushmoor 001,E02004802,2547,1535,684,851,20,20,696,120,576,294,229,65,2
2021,Rushmoor 002,E02004803,2651,1239,444,795,27,27,1047,160,887,334,269,65,4
2021,Rushmoor 003,E02004804,2816,2291,1066,1225,24,24,155,16,139,346,299,47,0
2021,Rushmoor 004,E02004805,3504,2587,1280,1307,82,82,212,17,195,623,548,75,0
2021,Rushmoor 005,E02004806,3182,2417,1059,1358,61,61,288,35,253,416,298,118,0
2021,Rushmoor 006,E02004807,3927,2579,1215,1364,54,54,615,80,535,679,585,94,0
2021,Rushmoor 007,E02004808,4929,2666,960,1706,86,86,656,77,579,1516,1115,401,5
2021,Rushmoor 008,E02004809,3982,1155,228,927,193,193,695,116,579,1936,1127,809,3
2021,Rushmoor 009,E02004810,3210,1916,679,1237,85,85,569,88,481,637,569,68,3
2021,Rushmoor 010,E02004811,3426,2046,938,1108,21,21,476,59,417,879,796,83,4
2021,Rushmoor 011,E02004812,2568,1968,857,1111,11,11,95,6,89,494,429,65,0
2021,Rushmoor 012,E02004813,2560,1375,569,806,13,13,865,172,693,296,246,50,11
2021,Test Valley 001,E02004814,2948,2219,1139,1080,41,41,267,51,216,419,342,77,2
2021,Test Valley 002,E02004815,2864,1246,502,744,27,27,1163,371,792,424,379,45,4
2021,Test Valley 004,E02004817,3317,2008,988,1020,59,59,688,200,488,560,494,66,2
2021,Test Valley 005,E02004818,4158,2985,1631,1354,31,31,436,113,323,706,468,238,0
2021,Test Valley 006,E02004819,3378,2482,1297,1185,19,19,243,58,185,633,570,63,1
2021,Test Valley 007,E02004820,2945,1934,1078,856,44,44,337,97,240,628,287,341,2
2021,Test Valley 008,E02004821,2200,1624,1005,619,8,8,190,43,147,376,252,124,2
2021,Test Valley 009,E02004822,3389,2322,1394,928,32,32,464,101,363,571,407,164,0
2021,Test Valley 010,E02004823,3860,3078,1841,1237,31,31,297,82,215,452,395,57,2
2021,Test Valley 011,E02004824,3046,1917,1389,528,13,13,542,165,377,572,497,75,2
2021,Test Valley 012,E02004825,4627,3632,2113,1519,51,51,456,109,347,485,412,73,3
2021,Test Valley 013,E02004826,3926,2907,1513,1394,152,152,403,91,312,462,366,96,2
2021,Test Valley 014,E02004827,2826,2359,1121,1238,5,5,107,8,99,355,324,31,0
2021,Test Valley 015,E02004828,2929,2359,1275,1084,64,64,203,50,153,303,245,58,0
2021,Winchester 001,E02004829,2395,1631,838,793,50,50,217,102,115,497,250,247,0
2021,Winchester 002,E02004830,2789,1964,1081,883,38,38,422,302,120,362,299,63,3
2021,Winchester 003,E02004831,3896,2951,1670,1281,76,76,365,182,183,501,362,139,3
2021,Winchester 004,E02004832,3756,2659,1671,988,23,23,415,308,107,653,535,118,6
2021,Winchester 005,E02004833,3607,2337,1238,1099,35,35,658,412,246,571,514,57,6
2021,Winchester 006,E02004834,3343,1244,664,580,34,34,1422,1118,304,634,574,60,9
2021,Winchester 007,E02004835,4656,2321,1340,981,40,40,758,298,460,1536,1318,218,1
2021,Winchester 008,E02004836,2229,662,373,289,12,12,997,744,253,551,510,41,7
2021,Winchester 009,E02004837,3338,2435,1395,1040,39,39,280,182,98,582,516,66,2
2021,Winchester 010,E02004838,3963,3065,1689,1376,41,41,408,276,132,449,355,94,0
2021,Winchester 011,E02004839,3661,2810,1623,1187,38,38,358,201,157,451,331,120,4
2021,Winchester 012,E02004840,4485,3349,1884,1465,49,49,521,278,243,561,473,88,5
2021,Winchester 013,E02004841,4930,3288,1532,1756,95,95,555,316,239,979,852,127,13
2021,Winchester 014,E02004842,4657,3203,1651,1552,132,132,557,228,329,765,598,167,0
2021,Broxbourne 001,E02004843,2698,2257,1204,1053,14,14,154,21,133,272,244,28,1
2021,Broxbourne 002,E02004844,2885,2000,886,1114,29,29,444,70,374,407,371,36,5
2021,Broxbourne 003,E02004845,3634,2129,1067,1062,22,22,563,104,459,920,869,51,0
2021,Broxbourne 004,E02004846,2460,2081,1135,946,5,5,94,21,73,279,253,26,1
2021,Broxbourne 005,E02004847,4253,2645,1133,1512,59,59,791,151,640,757,684,73,1
2021,Broxbourne 006,E02004848,2934,2240,1059,1181,11,11,358,216,142,321,285,36,4
2021,Broxbourne 007,E02004849,2573,2166,1069,1097,54,54,141,23,118,212,185,27,0
2021,Broxbourne 008,E02004850,3056,2144,1034,1110,11,11,508,122,386,390,352,38,3
2021,Broxbourne 009,E02004851,2430,1742,840,902,51,51,402,88,314,235,206,29,0
2021,Broxbourne 010,E02004852,3305,2189,1128,1061,24,24,379,67,312,713,648,65,0
2021,Broxbourne 011,E02004853,2778,1875,810,1065,18,18,645,159,486,238,202,36,2
2021,Broxbourne 012,E02004854,3276,2178,1116,1062,31,31,295,90,205,770,706,64,2
2021,Broxbourne 013,E02004855,3573,1711,697,1014,92,92,909,267,642,853,778,75,8
2021,Dacorum 001,E02004856,2368,1701,809,892,18,18,373,320,53,271,241,30,5
2021,Dacorum 002,E02004857,2525,1893,994,899,16,16,230,175,55,386,345,41,0
2021,Dacorum 003,E02004858,2075,1394,693,701,4,4,410,363,47,263,236,27,4
2021,Dacorum 004,E02004859,2239,1790,1014,776,17,17,162,130,32,268,238,30,2
2021,Dacorum 005,E02004860,2431,1406,584,822,13,13,445,160,285,566,534,32,1
2021,Dacorum 006,E02004861,2397,1886,1115,771,11,11,269,192,77,229,172,57,2
2021,Dacorum 007,E02004862,3099,1591,730,861,8,8,1062,688,374,432,400,32,6
2021,Dacorum 008,E02004863,3159,1270,526,744,49,49,1425,1104,321,413,384,29,2
2021,Dacorum 009,E02004864,2894,2196,1226,970,4,4,152,69,83,542,476,66,0
2021,Dacorum 010,E02004865,2418,1430,655,775,4,4,568,484,84,409,365,44,7
2021,Dacorum 011,E02004866,2744,1519,687,832,4,4,926,853,73,290,261,29,5
2021,Dacorum 012,E02004867,2570,1791,851,940,24,24,537,436,101,214,185,29,4
2021,Dacorum 013,E02004868,3063,1528,641,887,30,30,1129,724,405,371,332,39,5
2021,Dacorum 014,E02004869,2370,1667,816,851,4,4,340,318,22,355,322,33,4
2021,Dacorum 015,E02004870,5027,2507,1052,1455,74,74,1299,784,515,1143,1076,67,4
2021,Dacorum 016,E02004871,2041,1294,623,671,2,2,517,494,23,224,200,24,4
2021,Dacorum 017,E02004872,2927,2136,1168,968,9,9,528,435,93,252,224,28,2
2021,Dacorum 018,E02004873,5106,3389,1434,1955,42,42,665,370,295,1006,930,76,4
2021,Dacorum 019,E02004874,2394,1493,696,797,9,9,586,399,187,305,276,29,1
2021,Dacorum 020,E02004875,3955,2309,926,1383,31,31,1100,886,214,508,454,54,7
2021,Dacorum 021,E02004876,3472,2747,1512,1235,15,15,316,235,81,393,343,50,1
2021,Dacorum 022,E02004877,2136,1603,848,755,5,5,277,243,34,251,220,31,0
2021,East Hertfordshire 001,E02004878,3693,2770,1366,1404,75,75,488,54,434,359,301,58,1
2021,East Hertfordshire 003,E02004880,4198,3199,1448,1751,140,140,392,48,344,467,394,73,0
2021,East Hertfordshire 004,E02004881,2986,1940,988,952,50,50,239,17,222,755,700,55,2
2021,East Hertfordshire 005,E02004882,3200,2141,1040,1101,49,49,384,50,334,625,584,41,1
2021,East Hertfordshire 006,E02004883,2524,1912,961,951,22,22,311,35,276,279,229,50,0
2021,East Hertfordshire 007,E02004884,4534,2498,1138,1360,64,64,926,114,812,1045,964,81,1
2021,East Hertfordshire 008,E02004885,3246,2734,1310,1424,18,18,63,12,51,431,395,36,0
2021,East Hertfordshire 009,E02004886,2571,1791,894,897,27,27,405,60,345,347,288,59,1
2021,East Hertfordshire 010,E02004887,3084,2218,1209,1009,31,31,411,53,358,423,364,59,1
2021,East Hertfordshire 011,E02004888,3655,2788,1503,1285,18,18,334,57,277,513,476,37,2
2021,East Hertfordshire 012,E02004889,4719,3124,1530,1594,42,42,781,114,667,772,708,64,0
2021,East Hertfordshire 013,E02004890,3804,2642,1283,1359,115,115,414,59,355,633,581,52,0
2021,East Hertfordshire 014,E02004891,3385,2489,1243,1246,19,19,369,36,333,508,466,42,0
2021,East Hertfordshire 015,E02004892,2529,1395,651,744,71,71,787,93,694,272,248,24,4
2021,East Hertfordshire 016,E02004893,2372,1673,624,1049,52,52,261,38,223,385,360,25,1
2021,East Hertfordshire 017,E02004894,4530,2716,1302,1414,52,52,558,70,488,1202,1115,87,2
2021,East Hertfordshire 018,E02004895,3689,2573,1330,1243,27,27,495,69,426,593,449,144,1
2021,Hertsmere 001,E02004896,3381,2556,1549,1007,8,8,150,14,136,667,598,69,0
2021,Hertsmere 002,E02004897,2609,1968,1051,917,13,13,324,19,305,303,274,29,1
2021,Hertsmere 003,E02004898,3188,1948,1019,929,14,14,716,160,556,505,483,22,5
2021,Hertsmere 004,E02004899,2101,1414,638,776,29,29,383,41,342,274,216,58,1
2021,Hertsmere 005,E02004900,3189,2450,1279,1171,16,16,260,15,245,463,416,47,0
2021,Hertsmere 006,E02004901,4072,1787,647,1140,48,48,1615,246,1369,613,555,58,9
2021,Hertsmere 007,E02004902,3057,1611,686,925,35,35,831,80,751,580,533,47,0
2021,Hertsmere 008,E02004903,2877,1786,786,1000,56,56,488,40,448,546,501,45,1
2021,Hertsmere 009,E02004904,2864,1472,633,839,89,89,773,67,706,529,476,53,1
2021,Hertsmere 010,E02004905,2417,1757,811,946,11,11,159,27,132,490,419,71,0
2021,Hertsmere 011,E02004906,4204,2392,962,1430,100,100,757,84,673,952,884,68,3
2021,Hertsmere 012,E02004907,4411,2999,1469,1530,43,43,620,51,569,748,661,87,1
2021,Hertsmere 013,E02004908,4310,3261,1698,1563,24,24,324,28,296,700,527,173,1
2021,North Hertfordshire 001,E02004909,2530,1536,725,811,37,37,446,161,285,510,462,48,1
2021,North Hertfordshire 002,E02004910,4957,3768,2017,1751,61,61,449,164,285,679,595,84,0
2021,North Hertfordshire 003,E02004911,3037,1555,793,762,30,30,1171,411,760,280,240,40,1
2021,North Hertfordshire 004,E02004912,4680,3076,1620,1456,57,57,741,274,467,806,695,111,0
2021,North Hertfordshire 006,E02004914,3469,1893,912,981,61,61,1034,202,832,479,447,32,2
2021,North Hertfordshire 007,E02004915,2470,1261,620,641,53,53,782,192,590,374,337,37,0
2021,North Hertfordshire 008,E02004916,3085,2110,1290,820,16,16,617,186,431,342,300,42,0
2021,North Hertfordshire 009,E02004917,2694,1658,942,716,7,7,796,321,475,233,197,36,0
2021,North Hertfordshire 010,E02004918,3675,2136,925,1211,63,63,405,87,318,1070,1017,53,1
2021,North Hertfordshire 011,E02004919,3211,2042,959,1083,46,46,628,256,372,495,448,47,0
2021,North Hertfordshire 012,E02004920,5042,3193,1775,1418,39,39,1035,422,613,772,701,71,3
2021,North Hertfordshire 013,E02004921,3307,2456,1273,1183,9,9,247,94,153,595,536,59,0
2021,North Hertfordshire 014,E02004922,4159,2690,1428,1262,43,43,853,327,526,572,481,91,1
2021,North Hertfordshire 015,E02004923,4434,3163,1714,1449,24,24,640,197,443,607,521,86,0
2021,St Albans 001,E02004924,2868,2318,1072,1246,10,10,213,154,59,325,293,32,2
2021,St Albans 002,E02004925,2934,2103,950,1153,14,14,452,312,140,361,326,35,4
2021,St Albans 003,E02004926,3293,2453,1342,1111,13,13,162,88,74,665,602,63,0
2021,St Albans 004,E02004927,2650,2009,1109,900,7,7,396,326,70,238,208,30,0
2021,St Albans 005,E02004928,2656,2285,1229,1056,2,2,104,95,9,261,238,23,4
2021,St Albans 006,E02004929,2576,1941,1048,893,7,7,349,262,87,278,229,49,1
2021,St Albans 007,E02004930,2835,2088,1030,1058,6,6,290,216,74,450,418,32,1
2021,St Albans 008,E02004931,2720,2004,998,1006,24,24,333,208,125,356,334,22,3
2021,St Albans 009,E02004932,2954,1830,794,1036,14,14,812,486,326,294,259,35,4
2021,St Albans 010,E02004933,2529,2136,1016,1120,1,1,98,74,24,294,265,29,0
2021,St Albans 011,E02004934,3294,1865,806,1059,33,33,371,195,176,1021,957,64,4
2021,St Albans 012,E02004935,4372,2140,851,1289,17,17,549,217,332,1662,1582,80,4
2021,St Albans 013,E02004936,2425,1894,782,1112,6,6,113,51,62,412,373,39,0
2021,St Albans 014,E02004937,3002,2418,1378,1040,20,20,97,25,72,467,404,63,0
2021,St Albans 016,E02004939,2696,1728,892,836,13,13,623,506,117,331,296,35,1
2021,St Albans 017,E02004940,3000,1702,748,954,12,12,712,576,136,564,505,59,10
2021,St Albans 018,E02004941,3894,2569,1154,1415,51,51,608,402,206,663,608,55,3
2021,St Albans 019,E02004942,2626,1964,1065,899,14,14,342,190,152,300,253,47,6
2021,St Albans 020,E02004943,3303,2759,1546,1213,19,19,127,63,64,395,344,51,3
2021,Stevenage 001,E02004944,3100,1687,619,1068,185,185,787,635,152,440,403,37,1
2021,Stevenage 002,E02004945,4855,2901,1382,1519,91,91,1050,587,463,811,747,64,2
2021,Stevenage 003,E02004946,2630,1433,672,761,39,39,746,401,345,411,381,30,1
2021,Stevenage 005,E02004948,2671,1378,673,705,8,8,755,586,169,528,480,48,2
2021,Stevenage 006,E02004949,3894,1899,945,954,51,51,1214,890,324,728,678,50,2
2021,Stevenage 007,E02004950,2664,1692,727,965,48,48,625,531,94,295,254,41,4
2021,Stevenage 008,E02004951,3422,1502,686,816,22,22,1219,1090,129,674,625,49,5
2021,Stevenage 009,E02004952,2759,1720,763,957,13,13,662,627,35,360,331,29,4
2021,Stevenage 010,E02004953,2493,1357,552,805,11,11,858,786,72,267,233,34,0
2021,Stevenage 011,E02004954,2916,1557,690,867,128,128,876,664,212,353,314,39,2
2021,Stevenage 012,E02004955,2412,1614,812,802,10,10,554,472,82,232,206,26,2
2021,Three Rivers 001,E02004956,3858,2772,1429,1343,39,39,500,107,393,543,489,54,4
2021,Three Rivers 002,E02004957,4205,2819,1216,1603,76,76,805,223,582,502,452,50,3
2021,Three Rivers 003,E02004958,3076,2440,1273,1167,37,37,314,68,246,283,216,67,2
2021,Three Rivers 004,E02004959,2424,1908,1034,874,8,8,83,17,66,425,374,51,0
2021,Three Rivers 005,E02004960,2188,1735,921,814,5,5,157,37,120,291,254,37,0
2021,Three Rivers 006,E02004961,3774,3073,1535,1538,9,9,205,29,176,487,443,44,0
2021,Three Rivers 007,E02004962,3669,2488,1157,1331,12,12,499,127,372,665,608,57,5
2021,Three Rivers 008,E02004963,2785,1796,769,1027,16,16,717,209,508,254,223,31,2
2021,Three Rivers 009,E02004964,2319,1428,645,783,9,9,599,160,439,280,247,33,3
2021,Three Rivers 010,E02004965,2752,2122,1161,961,10,10,284,96,188,336,292,44,0
2021,Three Rivers 011,E02004966,2596,2030,1145,885,6,6,47,14,33,512,349,163,1
2021,Three Rivers 012,E02004967,3223,1529,521,1008,53,53,1258,430,828,381,350,31,2
2021,Watford 001,E02004968,3021,1758,752,1006,32,32,773,232,541,455,414,41,3
2021,Watford 002,E02004969,2819,1964,925,1039,8,8,425,110,315,421,373,48,1
2021,Watford 003,E02004970,3273,1814,814,1000,37,37,980,292,688,440,392,48,2
2021,Watford 004,E02004971,3092,1827,690,1137,31,31,655,204,451,578,538,40,1
2021,Watford 005,E02004972,2397,1776,878,898,6,6,115,30,85,498,467,31,2
2021,Watford 006,E02004973,3413,1716,606,1110,15,15,270,84,186,1408,1338,70,4
2021,Watford 007,E02004974,3592,2208,1038,1170,32,32,296,45,251,1056,980,76,0
2021,Watford 008,E02004975,2939,2186,1093,1093,36,36,165,26,139,552,520,32,0
2021,Watford 009,E02004976,5149,1627,707,920,95,95,761,114,647,2665,2558,107,1
2021,Watford 010,E02004977,3162,1544,647,897,13,13,217,25,192,1388,1308,80,0
2021,Watford 011,E02004978,3853,1486,544,942,103,103,1114,264,850,1149,1088,61,1
2021,Watford 012,E02004979,2923,1941,885,1056,12,12,403,104,299,566,528,38,1
2021,Welwyn Hatfield 001,E02004980,2432,2086,1128,958,6,6,138,116,22,201,168,33,1
2021,Welwyn Hatfield 002,E02004981,3231,2226,1073,1153,31,31,518,322,196,452,400,52,4
2021,Welwyn Hatfield 003,E02004982,2398,1638,870,768,14,14,538,495,43,205,181,24,3
2021,Welwyn Hatfield 004,E02004983,2604,1453,700,753,16,16,789,659,130,340,310,30,6
2021,Welwyn Hatfield 005,E02004984,2893,1673,842,831,12,12,779,464,315,420,394,26,9
2021,Welwyn Hatfield 006,E02004985,3100,1992,1165,827,18,18,711,489,222,371,341,30,8
2021,Welwyn Hatfield 007,E02004986,3735,1310,409,901,273,273,1646,1200,446,493,464,29,13
2021,Welwyn Hatfield 008,E02004987,3037,1732,714,1018,45,45,1045,617,428,214,192,22,1
2021,Welwyn Hatfield 009,E02004988,3111,1514,594,920,36,36,1108,825,283,449,422,27,4
2021,Welwyn Hatfield 010,E02004989,3989,1750,746,1004,69,69,1069,650,419,1090,1031,59,11
2021,Welwyn Hatfield 011,E02004990,2913,1467,710,757,34,34,711,475,236,701,647,54,0
2021,Welwyn Hatfield 012,E02004991,3097,1053,426,627,41,41,1117,815,302,875,821,54,11
2021,Welwyn Hatfield 013,E02004992,2840,1146,503,643,33,33,817,629,188,832,769,63,12
2021,Welwyn Hatfield 015,E02004994,2334,1963,1050,913,3,3,74,63,11,294,238,56,0
2021,Welwyn Hatfield 016,E02004995,2200,1831,1036,795,8,8,105,57,48,256,222,34,0
2021,Ashford 001,E02004996,3495,2347,1251,1096,44,44,476,345,131,623,528,95,5
2021,Ashford 002,E02004997,3431,2570,1497,1073,29,29,430,332,98,398,297,101,4
2021,Ashford 003,E02004998,2713,2129,1181,948,24,24,186,105,81,374,320,54,0
2021,Ashford 005,E02005000,4958,2234,947,1287,73,73,1015,591,424,1618,1498,120,18
2021,Ashford 006,E02005001,3790,2818,1406,1412,45,45,376,251,125,551,455,96,0
2021,Ashford 007,E02005002,4080,2218,957,1261,64,64,903,737,166,883,799,84,12
2021,Ashford 008,E02005003,3290,1701,636,1065,90,90,928,434,494,566,503,63,5
2021,Ashford 009,E02005004,4479,2906,1095,1811,89,89,538,348,190,942,847,95,4
2021,Ashford 010,E02005005,4124,3155,1506,1649,156,156,315,140,175,498,395,103,0
2021,Ashford 011,E02005006,2502,1948,1216,732,30,30,255,183,72,269,203,66,0
2021,Ashford 012,E02005007,3813,2828,1525,1303,83,83,295,203,92,601,504,97,6
2021,Ashford 013,E02005008,4105,2874,1988,886,72,72,539,344,195,616,512,104,4
2021,Ashford 014,E02005009,2507,1879,1131,748,19,19,328,252,76,275,222,53,6
2021,Canterbury 001,E02005010,3670,1836,1045,791,28,28,339,160,179,1466,1350,116,1
2021,Canterbury 002,E02005011,3338,2789,1877,912,65,65,179,90,89,305,249,56,0
2021,Canterbury 003,E02005012,3802,2740,1585,1155,16,16,532,355,177,509,444,65,5
2021,Canterbury 004,E02005013,3667,2735,1738,997,19,19,381,353,28,527,447,80,5
2021,Canterbury 005,E02005014,3731,3301,2206,1095,10,10,36,21,15,383,327,56,1
2021,Canterbury 006,E02005015,3827,3045,1560,1485,90,90,174,47,127,518,443,75,0
2021,Canterbury 007,E02005016,3425,2425,1470,955,14,14,494,306,188,488,425,63,4
2021,Canterbury 008,E02005017,3166,2169,1264,905,17,17,115,95,20,864,781,83,1
2021,Canterbury 009,E02005018,3709,2979,1864,1115,28,28,250,160,90,451,386,65,1
2021,Canterbury 010,E02005019,2548,1829,975,854,27,27,294,189,105,396,310,86,2
2021,Canterbury 011,E02005020,3084,2153,1226,927,22,22,469,373,96,432,358,74,8
2021,Canterbury 012,E02005021,2669,2107,1303,804,11,11,124,67,57,426,366,60,1
2021,Canterbury 013,E02005022,2960,1118,694,424,17,17,763,305,458,1056,989,67,6
2021,Canterbury 014,E02005023,3557,942,443,499,69,69,1475,1091,384,1060,968,92,11
2021,Canterbury 016,E02005025,3627,1992,1253,739,40,40,369,212,157,1225,1097,128,1
2021,Canterbury 017,E02005026,3204,2376,1237,1139,11,11,330,200,130,485,420,65,2
2021,Canterbury 018,E02005027,2274,1788,1104,684,11,11,153,102,51,319,247,72,3
2021,Dartford 001,E02005028,5306,2981,543,2438,170,170,1430,1081,349,710,663,47,15
2021,Dartford 002,E02005029,5932,3538,864,2674,385,385,524,192,332,1483,1396,87,2
2021,Dartford 003,E02005030,4919,2881,1118,1763,175,175,420,181,239,1438,1337,101,5
2021,Dartford 004,E02005031,3329,1677,619,1058,70,70,840,644,196,726,672,54,16
2021,Dartford 005,E02005032,3963,2438,957,1481,35,35,308,177,131,1178,1107,71,4
2021,Dartford 006,E02005033,3156,1752,635,1117,76,76,659,504,155,662,610,52,7
2021,Dartford 007,E02005034,2823,2493,1256,1237,5,5,30,20,10,295,253,42,0
2021,Dartford 008,E02005035,3134,2440,1201,1239,35,35,203,114,89,456,416,40,0
2021,Dartford 009,E02005036,2598,1325,536,789,9,9,896,600,296,360,327,33,8
2021,Dartford 010,E02005037,2781,2392,1347,1045,19,19,140,59,81,229,203,26,1
2021,Dartford 011,E02005038,2355,1946,1015,931,6,6,204,164,40,197,163,34,2
2021,Dartford 012,E02005039,2669,1843,864,979,16,16,517,424,93,290,253,37,3
2021,Dartford 013,E02005040,2729,2291,1347,944,43,43,138,115,23,252,218,34,5
2021,Dover 001,E02005041,3007,2192,1321,871,27,27,350,198,152,435,347,88,3
2021,Dover 002,E02005042,4016,2855,1871,984,28,28,536,396,140,588,490,98,9
2021,Dover 003,E02005043,3330,2381,1586,795,50,50,318,217,101,574,500,74,7
2021,Dover 004,E02005044,3224,2214,1574,640,18,18,114,45,69,878,782,96,0
2021,Dover 005,E02005045,3893,2601,1380,1221,62,62,580,328,252,647,543,104,3
2021,Dover 006,E02005046,3454,2322,943,1379,57,57,720,460,260,351,292,59,4
2021,Dover 007,E02005047,3442,2216,1348,868,14,14,704,411,293,506,438,68,2
2021,Dover 008,E02005048,2749,2289,1448,841,12,12,160,133,27,286,228,58,2
2021,Dover 009,E02005049,3188,2634,1874,760,19,19,161,121,40,373,299,74,1
2021,Dover 010,E02005050,4029,3363,1917,1446,37,37,266,62,204,363,299,64,0
2021,Dover 011,E02005051,5594,2598,1185,1413,19,19,1686,1011,675,1287,1188,99,4
2021,Dover 012,E02005052,3726,1589,911,678,12,12,644,345,299,1471,1292,179,10
2021,Dover 013,E02005053,3952,1752,860,892,13,13,672,391,281,1511,1413,98,4
2021,Dover 014,E02005054,2935,2471,1533,938,13,13,125,75,50,325,270,55,1
2021,Gravesham 001,E02005055,3209,1315,551,764,53,53,894,665,229,934,881,53,13
2021,Gravesham 002,E02005056,4652,1532,806,726,35,35,930,561,369,2136,2032,104,19
2021,Gravesham 003,E02005057,4362,2472,1127,1345,69,69,672,408,264,1146,1068,78,3
2021,Gravesham 004,E02005058,2958,1550,686,864,25,25,551,406,145,825,757,68,7
2021,Gravesham 005,E02005059,3779,2796,1444,1352,17,17,223,89,134,739,673,66,4
2021,Gravesham 006,E02005060,3348,2101,970,1131,128,128,729,533,196,382,335,47,8
2021,Gravesham 007,E02005061,2819,1539,680,859,23,23,967,873,94,278,246,32,12
2021,Gravesham 008,E02005062,2591,2079,1096,983,6,6,248,220,28,257,227,30,1
2021,Gravesham 009,E02005063,2678,1929,939,990,35,35,504,376,128,209,186,23,1
2021,Gravesham 010,E02005064,2663,2197,1272,925,7,7,249,202,47,205,163,42,5
2021,Gravesham 011,E02005065,3163,1669,695,974,31,31,1059,807,252,385,340,45,19
2021,Gravesham 012,E02005066,3184,2755,1647,1108,8,8,147,119,28,268,222,46,6
2021,Gravesham 013,E02005067,2319,2027,1106,921,10,10,96,49,47,184,146,38,2
2021,Maidstone 001,E02005068,2820,2375,1060,1315,17,17,72,16,56,356,300,56,0
2021,Maidstone 002,E02005069,3593,2689,1366,1323,27,27,185,19,166,692,623,69,0
2021,Maidstone 003,E02005070,4050,3479,1973,1506,57,57,92,18,74,422,350,72,0
2021,Maidstone 004,E02005071,5477,2129,906,1223,69,69,1098,219,879,2178,1855,323,3
2021,Maidstone 005,E02005072,3177,2663,1437,1226,14,14,86,11,75,414,368,46,0
2021,Maidstone 006,E02005073,5396,2436,987,1449,133,133,764,104,660,2061,1931,130,2
2021,Maidstone 007,E02005074,3373,2770,1555,1215,30,30,101,18,83,471,415,56,1
2021,Maidstone 008,E02005075,4221,2515,1073,1442,137,137,744,120,624,822,734,88,3
2021,Maidstone 009,E02005076,3908,2131,832,1299,98,98,712,150,562,966,894,72,1
2021,Maidstone 010,E02005077,3107,2044,1013,1031,37,37,730,183,547,295,238,57,1
2021,Maidstone 011,E02005078,3984,3006,1754,1252,86,86,374,55,319,518,412,106,0
2021,Maidstone 012,E02005079,3565,2869,1573,1296,65,65,296,48,248,335,302,33,0
2021,Maidstone 013,E02005080,4774,2103,955,1148,82,82,2188,528,1660,395,345,50,6
2021,Maidstone 014,E02005081,2999,2344,1396,948,35,35,259,41,218,361,294,67,0
2021,Maidstone 015,E02005082,4661,3378,1523,1855,164,164,598,92,506,520,416,104,1
2021,Maidstone 016,E02005083,3233,2533,1345,1188,77,77,349,68,281,273,230,43,1
2021,Maidstone 017,E02005084,3060,2233,1230,1003,71,71,327,83,244,429,320,109,0
2021,Maidstone 018,E02005085,3139,2262,1152,1110,84,84,347,80,267,446,361,85,0
2021,Maidstone 019,E02005086,2664,2033,1063,970,66,66,185,33,152,380,334,46,0
2021,Sevenoaks 001,E02005087,2864,2353,1298,1055,21,21,230,38,192,257,215,42,3
2021,Sevenoaks 002,E02005088,4031,1970,913,1057,78,78,1601,317,1284,373,330,43,9
2021,Sevenoaks 003,E02005089,2813,2218,1117,1101,32,32,241,47,194,322,276,46,0
2021,Sevenoaks 004,E02005090,2427,1985,1260,725,24,24,223,36,187,195,159,36,0
2021,Sevenoaks 005,E02005091,2906,2180,1200,980,75,75,306,52,254,345,274,71,0
2021,Sevenoaks 007,E02005093,2582,2159,1355,804,30,30,174,26,148,219,166,53,0
2021,Sevenoaks 008,E02005094,4060,2842,1374,1468,137,137,397,46,351,684,600,84,0
2021,Sevenoaks 009,E02005095,2977,2438,1373,1065,37,37,284,32,252,218,180,38,0
2021,Sevenoaks 010,E02005096,4029,2440,1173,1267,142,142,721,88,633,723,648,75,3
2021,Sevenoaks 011,E02005097,3449,2858,1474,1384,23,23,155,20,135,413,348,65,0
2021,Sevenoaks 012,E02005098,4067,2685,1473,1212,15,15,432,41,391,935,803,132,0
2021,Sevenoaks 013,E02005099,3350,2344,1259,1085,35,35,425,47,378,543,460,83,3
2021,Sevenoaks 014,E02005100,4168,2722,1378,1344,197,197,763,144,619,483,424,59,3
2021,Sevenoaks 015,E02005101,2828,2019,1124,895,34,34,324,32,292,450,349,101,1
2021,Folkestone and Hythe 001,E02005102,2705,2223,1475,748,14,14,132,97,35,331,241,90,5
2021,Folkestone and Hythe 002,E02005103,3880,2809,1306,1503,40,40,419,184,235,609,515,94,3
2021,Folkestone and Hythe 003,E02005104,3355,2008,1064,944,8,8,900,640,260,435,357,78,4
2021,Folkestone and Hythe 004,E02005105,3206,1593,751,842,9,9,489,254,235,1112,1031,81,3
2021,Folkestone and Hythe 005,E02005106,4021,2383,1154,1229,65,65,735,410,325,834,590,244,4
2021,Folkestone and Hythe 006,E02005107,5400,3938,2269,1669,41,41,243,99,144,1176,1051,125,2
2021,Folkestone and Hythe 008,E02005109,2976,2575,1740,835,18,18,64,43,21,319,261,58,0
2021,Folkestone and Hythe 009,E02005110,3030,2619,1577,1042,16,16,110,77,33,285,209,76,0
2021,Folkestone and Hythe 010,E02005111,3686,2286,1609,677,48,48,620,457,163,726,642,84,6
2021,Folkestone and Hythe 011,E02005112,3116,2395,1593,802,11,11,334,264,70,370,281,89,6
2021,Folkestone and Hythe 012,E02005113,3176,2400,1624,776,50,50,285,145,140,440,378,62,1
2021,Folkestone and Hythe 013,E02005114,2738,2012,1288,724,14,14,249,186,63,458,396,62,5
2021,Swale 001,E02005115,2617,1085,578,507,14,14,200,41,159,1318,1254,64,0
2021,Swale 002,E02005116,2629,1048,516,532,14,14,973,194,779,591,543,48,3
2021,Swale 003,E02005117,2782,2212,1350,862,8,8,253,38,215,308,247,61,1
2021,Swale 004,E02005118,4320,3006,1352,1654,90,90,442,69,373,781,710,71,1
2021,Swale 005,E02005119,2668,1771,991,780,39,39,314,56,258,544,485,59,0
2021,Swale 006,E02005120,3190,2327,1456,871,20,20,185,27,158,658,560,98,0
2021,Swale 007,E02005121,5227,3704,1333,2371,102,102,640,109,531,780,702,78,1
2021,Swale 008,E02005122,3100,2467,1296,1171,26,26,300,40,260,307,245,62,0
2021,Swale 009,E02005123,4893,3510,1469,2041,94,94,445,66,379,840,755,85,4
2021,Swale 010,E02005124,3800,1725,894,831,35,35,900,191,709,1138,1058,80,2
2021,Swale 011,E02005125,3379,2188,999,1189,50,50,558,91,467,583,523,60,0
2021,Swale 012,E02005126,3299,2518,1431,1087,13,13,267,45,222,501,442,59,0
2021,Swale 013,E02005127,3492,2773,1512,1261,69,69,252,26,226,398,339,59,0
2021,Swale 014,E02005128,3729,2626,1427,1199,42,42,610,78,532,450,375,75,1
2021,Swale 015,E02005129,5095,3175,1798,1377,78,78,849,140,709,992,872,120,1
2021,Swale 016,E02005130,3863,2563,1333,1230,117,117,565,65,500,615,515,100,3
2021,Swale 017,E02005131,2410,1817,1053,764,7,7,289,51,238,297,227,70,0
2021,Thanet 001,E02005132,4957,1438,808,630,20,20,664,179,485,2831,2724,107,4
2021,Thanet 002,E02005133,3848,3099,2026,1073,30,30,124,18,106,595,514,81,0
2021,Thanet 003,E02005134,3537,1346,653,693,11,11,456,143,313,1720,1613,107,4
2021,Thanet 004,E02005135,3195,1845,893,952,9,9,401,127,274,939,827,112,1
2021,Thanet 005,E02005136,3262,2442,1310,1132,6,6,351,112,239,462,391,71,1
2021,Thanet 006,E02005137,3104,1565,852,713,11,11,1064,638,426,457,398,59,7
2021,Thanet 007,E02005138,4176,2571,1501,1070,19,19,459,194,265,1127,1020,107,0
2021,Thanet 008,E02005139,4287,3523,2551,972,14,14,134,43,91,616,534,82,0
2021,Thanet 009,E02005140,3439,2681,1801,880,8,8,157,34,123,593,492,101,0
2021,Thanet 010,E02005141,3230,2212,1465,747,35,35,127,26,101,856,779,77,0
2021,Thanet 011,E02005142,3186,2368,1507,861,11,11,346,139,207,460,379,81,1
2021,Thanet 012,E02005143,3503,2322,1319,1003,9,9,395,100,295,777,695,82,0
2021,Thanet 013,E02005144,3536,1641,826,815,24,24,1252,643,609,616,529,87,3
2021,Thanet 014,E02005145,3472,2566,1476,1090,33,33,321,88,233,552,446,106,0
2021,Thanet 015,E02005146,3314,1939,906,1033,8,8,207,59,148,1160,1053,107,0
2021,Thanet 016,E02005147,4644,1796,1072,724,17,17,742,366,376,2085,1955,130,4
2021,Thanet 017,E02005148,3514,2809,1767,1042,16,16,198,33,165,490,407,83,1
2021,Tonbridge and Malling 001,E02005149,4946,3877,1624,2253,131,131,434,51,383,501,427,74,3
2021,Tonbridge and Malling 002,E02005150,4939,3157,1391,1766,118,118,949,125,824,714,636,78,1
2021,Tonbridge and Malling 003,E02005151,5149,3774,1867,1907,91,91,795,118,677,489,418,71,0
2021,Tonbridge and Malling 005,E02005153,3812,2574,1267,1307,72,72,839,88,751,326,261,65,1
2021,Tonbridge and Malling 006,E02005154,4632,3548,1868,1680,51,51,465,54,411,568,469,99,0
2021,Tonbridge and Malling 007,E02005155,4664,3560,1427,2133,104,104,408,37,371,591,516,75,1
2021,Tonbridge and Malling 008,E02005156,2939,2067,1213,854,45,45,522,45,477,305,232,73,0
2021,Tonbridge and Malling 009,E02005157,2738,1656,1033,623,55,55,875,92,783,152,126,26,0
2021,Tonbridge and Malling 010,E02005158,2588,2147,1179,968,12,12,183,27,156,246,202,44,0
2021,Tonbridge and Malling 011,E02005159,3138,2259,1328,931,34,34,656,85,571,188,162,26,1
2021,Tonbridge and Malling 012,E02005160,5373,2983,1403,1580,218,218,850,113,737,1322,1177,145,0
2021,Tonbridge and Malling 013,E02005161,3504,2245,992,1253,68,68,512,53,459,678,629,49,1
2021,Tunbridge Wells 001,E02005162,4333,3068,1651,1417,44,44,621,84,537,600,528,72,0
2021,Tunbridge Wells 002,E02005163,3124,2255,1059,1196,18,18,362,45,317,488,427,61,1
2021,Tunbridge Wells 003,E02005164,3740,2343,1005,1338,98,98,689,91,598,610,546,64,0
2021,Tunbridge Wells 004,E02005165,3094,2258,1299,959,20,20,460,49,411,349,267,82,7
2021,Tunbridge Wells 005,E02005166,2801,1297,603,694,58,58,1095,159,936,351,311,40,0
2021,Tunbridge Wells 006,E02005167,2941,2391,1318,1073,19,19,207,22,185,324,283,41,0
2021,Tunbridge Wells 007,E02005168,3191,2265,1104,1161,50,50,147,18,129,728,680,48,1
2021,Tunbridge Wells 008,E02005169,4634,1859,880,979,48,48,529,81,448,2197,2077,120,1
2021,Tunbridge Wells 009,E02005170,4137,2773,1351,1422,37,37,416,54,362,911,842,69,0
2021,Tunbridge Wells 010,E02005171,2688,1345,690,655,26,26,864,148,716,451,408,43,2
2021,Tunbridge Wells 011,E02005172,3273,2402,1307,1095,10,10,373,37,336,487,378,109,1
2021,Tunbridge Wells 012,E02005173,3696,2673,1456,1217,16,16,219,21,198,787,732,55,1
2021,Tunbridge Wells 013,E02005174,3077,2037,1201,836,45,45,529,66,463,466,376,90,0
2021,Tunbridge Wells 014,E02005175,3495,2427,1400,1027,34,34,516,70,446,517,440,77,1
2021,Burnley 001,E02005176,3777,2807,1507,1300,4,4,405,134,271,558,477,81,3
2021,Burnley 002,E02005177,2575,1455,854,601,3,3,284,89,195,831,756,75,2
2021,Burnley 003,E02005178,3696,1698,1053,645,10,10,426,82,344,1556,1365,191,6
2021,Burnley 004,E02005179,4294,2240,1228,1012,15,15,828,254,574,1210,1085,125,1
2021,Burnley 005,E02005180,3009,2446,1327,1119,6,6,258,82,176,296,248,48,3
2021,Burnley 006,E02005181,3084,1729,835,894,9,9,391,75,316,955,872,83,0
2021,Burnley 007,E02005182,2837,1161,636,525,2,2,601,107,494,1069,982,87,4
2021,Burnley 008,E02005183,2862,1684,966,718,5,5,834,243,591,328,270,58,11
2021,Burnley 009,E02005184,2278,1898,1157,741,3,3,119,29,90,258,199,59,0
2021,Burnley 010,E02005185,4226,1691,851,840,15,15,1294,428,866,1219,1116,103,7
2021,Burnley 011,E02005186,2664,2076,1043,1033,2,2,163,58,105,421,361,60,2
2021,Chorley 001,E02005189,2401,1090,548,542,10,10,1031,101,930,267,222,45,3
2021,Chorley 002,E02005190,2659,2190,1276,914,18,18,132,13,119,319,246,73,0
2021,Chorley 003,E02005191,4084,3395,1751,1644,69,69,292,23,269,328,268,60,0
2021,Chorley 004,E02005192,3687,2955,1307,1648,28,28,246,46,200,457,389,68,1
2021,Chorley 005,E02005193,3683,3120,1726,1394,28,28,224,53,171,311,262,49,0
2021,Chorley 006,E02005194,3571,2377,1326,1051,23,23,592,96,496,577,509,68,2
2021,Chorley 007,E02005195,2551,2024,1167,857,19,19,187,28,159,318,262,56,3
2021,Chorley 008,E02005196,4828,3435,1550,1885,31,31,658,60,598,704,637,67,0
2021,Chorley 009,E02005197,3197,1836,886,950,11,11,686,150,536,660,585,75,4
2021,Chorley 010,E02005198,4416,2748,1318,1430,15,15,665,179,486,985,891,94,3
2021,Chorley 011,E02005199,3257,2739,1607,1132,38,38,191,32,159,288,242,46,1
2021,Chorley 012,E02005200,3854,2307,920,1387,24,24,882,232,650,640,581,59,1
2021,Chorley 013,E02005201,3540,2573,1297,1276,23,23,483,113,370,460,402,58,1
2021,Chorley 014,E02005202,4407,3367,1879,1488,21,21,373,96,277,646,555,91,0
2021,Fylde 001,E02005203,3552,2761,1568,1193,16,16,241,37,204,534,347,187,0
2021,Fylde 002,E02005204,5556,3814,1942,1872,102,102,709,107,602,929,820,109,2
2021,Fylde 003,E02005205,2630,2067,1242,825,21,21,275,54,221,266,207,59,1
2021,Fylde 004,E02005206,3525,2376,1362,1014,52,52,460,58,402,636,555,81,1
2021,Fylde 005,E02005207,3946,3100,2016,1084,9,9,212,35,177,625,538,87,0
2021,Fylde 006,E02005208,5223,2981,1970,1011,19,19,298,26,272,1923,1793,130,2
2021,Fylde 007,E02005209,4009,3084,1827,1257,36,36,311,35,276,577,474,103,1
2021,Fylde 008,E02005210,4946,3691,2460,1231,17,17,397,27,370,841,715,126,0
2021,Fylde 009,E02005211,4220,3073,1984,1089,15,15,231,25,206,900,790,110,1
2021,Hyndburn 001,E02005212,4912,3254,1830,1424,36,36,504,108,396,1116,1003,113,2
2021,Hyndburn 002,E02005213,4835,3326,1644,1682,12,12,472,126,346,1022,913,109,3
2021,Hyndburn 003,E02005214,2996,1922,1083,839,4,4,262,58,204,808,718,90,0
2021,Hyndburn 004,E02005215,5563,3195,1681,1514,6,6,838,277,561,1520,1324,196,4
2021,Hyndburn 005,E02005216,2297,1313,678,635,0,0,497,148,349,484,437,47,3
2021,Hyndburn 006,E02005217,4327,2212,1343,869,8,8,940,225,715,1161,975,186,6
2021,Hyndburn 007,E02005218,3315,2001,971,1030,5,5,569,101,468,739,670,69,1
2021,Hyndburn 008,E02005219,3875,2601,1442,1159,4,4,431,110,321,839,761,78,0
2021,Hyndburn 009,E02005220,2670,2120,1245,875,2,2,201,72,129,346,287,59,1
2021,Lancaster 001,E02005221,4495,3534,2212,1322,25,25,298,234,64,637,494,143,1
2021,Lancaster 002,E02005222,2617,2098,1432,666,20,20,85,44,41,414,303,111,0
2021,Lancaster 003,E02005223,3232,2860,1851,1009,17,17,84,55,29,271,219,52,0
2021,Lancaster 004,E02005224,2555,2011,1426,585,15,15,43,14,29,486,413,73,0
2021,Lancaster 005,E02005225,2647,2153,1305,848,20,20,173,118,55,300,244,56,1
2021,Lancaster 006,E02005226,3364,1506,817,689,41,41,477,37,440,1340,1213,127,0
2021,Lancaster 008,E02005228,2396,1799,894,905,13,13,66,31,35,517,448,69,1
2021,Lancaster 009,E02005229,2630,1114,599,515,43,43,194,22,172,1278,1208,70,1
2021,Lancaster 010,E02005230,3139,1899,1222,677,14,14,632,395,237,591,518,73,3
2021,Lancaster 011,E02005231,3734,2032,996,1036,26,26,888,669,219,780,678,102,8
2021,Lancaster 013,E02005233,3162,2154,943,1211,33,33,493,373,120,473,409,64,9
2021,Lancaster 014,E02005234,3472,1245,687,558,39,39,569,161,408,1616,1515,101,3
2021,Lancaster 015,E02005235,2104,991,563,428,8,8,132,31,101,969,925,44,4
2021,Lancaster 016,E02005236,5760,4364,2355,2009,11,11,408,269,139,976,821,155,1
2021,Lancaster 017,E02005237,4292,2803,1486,1317,86,86,530,296,234,869,781,88,4
2021,Lancaster 018,E02005238,2399,1693,923,770,5,5,320,188,132,380,346,34,1
2021,Lancaster 019,E02005239,2698,2109,1228,881,52,52,82,51,31,455,370,85,0
2021,Pendle 001,E02005240,2401,1654,876,778,9,9,253,84,169,483,425,58,2
2021,Pendle 002,E02005241,2504,1777,999,778,0,0,137,47,90,590,526,64,0
2021,Pendle 003,E02005242,2777,2052,1199,853,6,6,243,74,169,476,419,57,0
2021,Pendle 006,E02005245,3062,2470,1349,1121,8,8,150,43,107,434,367,67,0
2021,Pendle 007,E02005246,2475,1336,700,636,2,2,449,109,340,687,628,59,1
2021,Pendle 008,E02005247,4491,3472,2051,1421,7,7,270,69,201,739,637,102,3
2021,Pendle 009,E02005248,2625,1231,780,451,8,8,539,190,349,839,737,102,8
2021,Pendle 010,E02005249,3940,1822,1085,737,11,11,623,172,451,1480,1325,155,4
2021,Pendle 011,E02005250,2802,1606,1022,584,9,9,263,75,188,923,791,132,1
2021,Pendle 012,E02005251,2623,1892,1026,866,3,3,378,145,233,347,288,59,3
2021,Pendle 013,E02005252,3556,2597,1533,1064,4,4,231,49,182,722,565,157,2
2021,Preston 001,E02005253,2775,2341,1257,1084,47,47,100,11,89,287,236,51,0
2021,Preston 002,E02005254,3779,3295,1537,1758,108,108,110,10,100,266,209,57,0
2021,Preston 003,E02005255,3924,3243,1822,1421,27,27,173,7,166,481,402,79,0
2021,Preston 004,E02005256,2870,2202,1156,1046,29,29,197,10,187,442,391,51,0
2021,Preston 005,E02005257,2776,1219,640,579,20,20,1186,150,1036,349,306,43,2
2021,Preston 006,E02005258,3249,2414,1470,944,39,39,316,33,283,480,391,89,0
2021,Preston 007,E02005259,4098,2420,1230,1190,12,12,1116,248,868,546,461,85,4
2021,Preston 008,E02005260,2861,2402,1361,1041,15,15,99,13,86,345,285,60,0
2021,Preston 009,E02005261,4003,1822,825,997,45,45,1707,465,1242,426,372,54,3
2021,Preston 010,E02005262,3249,2222,978,1244,47,47,350,43,307,629,575,54,1
2021,Preston 011,E02005263,2742,1194,675,519,10,10,386,49,337,1147,1036,111,5
2021,Preston 012,E02005264,4912,2214,1046,1168,19,19,579,64,515,2100,1952,148,0
2021,Preston 013,E02005265,4787,2845,1344,1501,18,18,1037,192,845,882,760,122,5
2021,Preston 014,E02005266,3395,1198,657,541,22,22,1048,214,834,1124,1023,101,3
2021,Preston 015,E02005267,2026,658,410,248,8,8,675,96,579,681,616,65,4
2021,Preston 016,E02005268,3441,1815,1050,765,17,17,743,143,600,864,766,98,2
2021,Preston 017,E02005269,4731,1242,762,480,34,34,1159,132,1027,2286,2144,142,10
2021,Ribble Valley 001,E02005270,3060,2296,1509,787,25,25,124,6,118,615,466,149,0
2021,Ribble Valley 002,E02005271,3663,2631,1517,1114,56,56,314,40,274,661,566,95,1
2021,Ribble Valley 003,E02005272,4019,2636,1314,1322,80,80,715,133,582,588,498,90,0
2021,Ribble Valley 004,E02005273,2623,2008,1240,768,18,18,160,13,147,436,349,87,1
2021,Ribble Valley 005,E02005274,3401,2593,1450,1143,74,74,236,20,216,498,427,71,0
2021,Ribble Valley 006,E02005275,2544,1831,1028,803,31,31,231,39,192,451,385,66,0
2021,Ribble Valley 007,E02005276,3753,2980,1619,1361,92,92,255,29,226,426,335,91,0
2021,Ribble Valley 008,E02005277,3687,3211,1976,1235,29,29,119,14,105,328,247,81,0
2021,Rossendale 001,E02005278,3256,2625,1290,1335,9,9,221,42,179,400,325,75,1
2021,Rossendale 002,E02005279,4272,2645,1383,1262,4,4,715,177,538,906,794,112,2
2021,Rossendale 003,E02005280,4674,2985,1414,1571,6,6,792,224,568,886,770,116,5
2021,Rossendale 004,E02005281,3865,2484,1232,1252,20,20,659,185,474,701,596,105,1
2021,Rossendale 007,E02005284,2608,2074,1109,965,13,13,243,57,186,277,217,60,1
2021,Rossendale 008,E02005285,2789,2200,1192,1008,9,9,173,37,136,405,339,66,2
2021,Rossendale 009,E02005286,3488,2330,1171,1159,5,5,566,165,401,587,504,83,0
2021,South Ribble 001,E02005287,2205,1956,1079,877,4,4,61,1,60,184,152,32,0
2021,South Ribble 002,E02005288,2643,2186,1308,878,11,11,143,10,133,303,251,52,0
2021,South Ribble 003,E02005289,2614,2303,1422,881,8,8,44,4,40,259,205,54,0
2021,South Ribble 004,E02005290,3073,2645,1310,1335,4,4,62,3,59,362,324,38,0
2021,South Ribble 005,E02005291,2528,1962,996,966,56,56,170,16,154,339,290,49,1
2021,South Ribble 006,E02005292,2583,1517,776,741,33,33,666,56,610,365,322,43,2
2021,South Ribble 007,E02005293,2559,1692,985,707,6,6,327,29,298,532,475,57,2
2021,South Ribble 008,E02005294,2964,2116,972,1144,42,42,336,36,300,470,429,41,0
2021,South Ribble 009,E02005295,3319,2698,1330,1368,11,11,166,18,148,444,383,61,0
2021,South Ribble 010,E02005296,2548,2217,1312,905,24,24,81,4,77,226,173,53,0
2021,South Ribble 011,E02005297,3645,3074,1860,1214,13,13,154,10,144,404,329,75,0
2021,South Ribble 012,E02005298,3551,2888,1290,1598,55,55,236,33,203,372,309,63,0
2021,South Ribble 013,E02005299,3364,2344,980,1364,33,33,338,33,305,649,571,78,0
2021,South Ribble 014,E02005300,2113,1578,821,757,7,7,341,30,311,187,163,24,0
2021,South Ribble 015,E02005301,2790,1788,969,819,20,20,648,68,580,333,276,57,1
2021,South Ribble 016,E02005302,3308,2578,1318,1260,23,23,215,20,195,492,437,55,0
2021,South Ribble 017,E02005303,2772,1403,699,704,24,24,1054,124,930,289,248,41,2
2021,West Lancashire 001,E02005304,3801,3138,1794,1344,47,47,184,132,52,428,348,80,4
2021,West Lancashire 002,E02005305,3500,2791,1718,1073,52,52,282,119,163,373,299,74,2
2021,West Lancashire 003,E02005306,3218,2601,1581,1020,24,24,208,126,82,377,292,85,8
2021,West Lancashire 004,E02005307,4055,3027,1556,1471,10,10,432,263,169,582,489,93,4
2021,West Lancashire 005,E02005308,2787,2406,1457,949,25,25,100,88,12,255,189,66,1
2021,West Lancashire 006,E02005309,3710,2986,1743,1243,25,25,300,244,56,394,341,53,5
2021,West Lancashire 007,E02005310,3477,1887,1028,859,96,96,587,319,268,899,814,85,8
2021,West Lancashire 008,E02005311,2386,2000,1222,778,15,15,99,83,16,270,204,66,2
2021,West Lancashire 009,E02005312,2683,2008,937,1071,48,48,354,275,79,269,232,37,4
2021,West Lancashire 010,E02005313,3591,1718,714,1004,14,14,1193,1141,52,652,584,68,14
2021,West Lancashire 011,E02005314,2893,1657,837,820,8,8,668,600,68,550,489,61,10
2021,West Lancashire 012,E02005315,3380,2973,1811,1162,35,35,131,115,16,237,190,47,4
2021,West Lancashire 013,E02005316,2707,1430,624,806,7,7,826,687,139,433,395,38,11
2021,West Lancashire 014,E02005317,3107,1227,598,629,19,19,1186,1024,162,668,608,60,7
2021,West Lancashire 015,E02005318,3244,2476,1368,1108,18,18,409,302,107,337,281,56,4
2021,Wyre 001,E02005319,4060,1958,1122,836,13,13,501,58,443,1587,1479,108,1
2021,Wyre 002,E02005320,2414,1752,973,779,17,17,258,45,213,386,342,44,1
2021,Wyre 003,E02005321,2590,1652,1126,526,15,15,608,126,482,315,265,50,0
2021,Wyre 004,E02005322,4822,3849,2550,1299,43,43,214,15,199,714,611,103,2
2021,Wyre 005,E02005323,3234,2021,1099,922,12,12,657,123,534,543,486,57,1
2021,Wyre 006,E02005324,2879,2127,1261,866,68,68,217,20,197,467,380,87,0
2021,Wyre 007,E02005325,4388,3516,2408,1108,66,66,242,24,218,563,481,82,1
2021,Wyre 008,E02005326,4037,2723,1752,971,8,8,196,27,169,1109,983,126,1
2021,Wyre 009,E02005327,2812,2264,1418,846,39,39,188,13,175,320,239,81,1
2021,Wyre 010,E02005328,3603,2963,1856,1107,25,25,49,4,45,566,486,80,0
2021,Wyre 011,E02005329,4212,2946,1474,1472,42,42,299,36,263,925,820,105,0
2021,Wyre 012,E02005330,3942,3394,2044,1350,14,14,61,10,51,473,393,80,0
2021,Wyre 013,E02005331,3946,2782,1591,1191,41,41,305,31,274,814,716,98,4
2021,Wyre 014,E02005332,3833,3291,2025,1266,5,5,74,10,64,463,384,79,0
2021,Blaby 002,E02005334,2346,2007,969,1038,13,13,48,3,45,278,241,37,0
2021,Blaby 003,E02005335,3078,2523,1399,1124,24,24,191,29,162,340,295,45,0
2021,Blaby 004,E02005336,2866,1941,783,1158,6,6,224,60,164,695,649,46,0
2021,Blaby 005,E02005337,3942,3014,1660,1354,18,18,203,18,185,707,629,78,0
2021,Blaby 006,E02005338,4793,3630,1698,1932,44,44,503,63,440,613,535,78,3
2021,Blaby 007,E02005339,3691,2912,1498,1414,38,38,228,36,192,513,464,49,0
2021,Blaby 008,E02005340,3914,2916,1571,1345,56,56,452,53,399,489,417,72,1
2021,Blaby 009,E02005341,3088,2389,1067,1322,45,45,351,42,309,303,260,43,0
2021,Blaby 010,E02005342,3134,2390,1314,1076,78,78,358,43,315,308,262,46,0
2021,Blaby 011,E02005343,3334,2707,1444,1263,40,40,259,45,214,328,276,52,0
2021,Blaby 012,E02005344,3899,3048,1508,1540,67,67,415,50,365,367,318,49,2
2021,Charnwood 001,E02005345,2810,2049,1189,860,33,33,283,67,216,444,408,36,1
2021,Charnwood 002,E02005346,5530,2081,1026,1055,74,74,1594,706,888,1771,1662,109,10
2021,Charnwood 003,E02005347,3655,1215,729,486,25,25,685,431,254,1720,1625,95,10
2021,Charnwood 004,E02005348,2496,1774,1107,667,9,9,284,167,117,425,395,30,4
2021,Charnwood 005,E02005349,3435,2538,1319,1219,28,28,362,226,136,503,446,57,4
2021,Charnwood 006,E02005350,3058,2168,1142,1026,37,37,341,203,138,512,453,59,0
2021,Charnwood 007,E02005351,2365,1285,765,520,11,11,479,381,98,582,531,51,8
2021,Charnwood 008,E02005352,2527,2138,1233,905,11,11,105,57,48,271,218,53,2
2021,Charnwood 009,E02005353,4152,2483,1154,1329,51,51,888,656,232,725,668,57,5
2021,Charnwood 010,E02005354,4102,3477,1992,1485,29,29,99,15,84,497,441,56,0
2021,Charnwood 011,E02005355,3222,2467,1325,1142,49,49,275,178,97,430,375,55,1
2021,Charnwood 012,E02005356,3219,2471,1395,1076,29,29,252,121,131,466,423,43,1
2021,Charnwood 013,E02005357,3549,2567,1169,1398,42,42,369,237,132,567,501,66,4
2021,Charnwood 014,E02005358,5235,3917,1805,2112,64,64,588,363,225,662,572,90,4
2021,Charnwood 015,E02005359,3039,2487,1303,1184,60,60,193,98,95,299,263,36,0
2021,Charnwood 016,E02005360,2600,2224,1351,873,4,4,111,89,22,258,194,64,3
2021,Charnwood 017,E02005361,2785,1904,1027,877,26,26,255,156,99,600,550,50,0
2021,Charnwood 018,E02005362,2994,2281,1183,1098,39,39,335,178,157,337,299,38,2
2021,Charnwood 019,E02005363,3554,2907,1546,1361,22,22,185,73,112,439,388,51,1
2021,Charnwood 020,E02005364,2096,1686,886,800,6,6,115,84,31,287,249,38,2
2021,Charnwood 021,E02005365,4026,2937,1716,1221,48,48,432,192,240,605,528,77,4
2021,Charnwood 022,E02005366,3338,2480,1258,1222,39,39,402,244,158,414,350,64,3
2021,Harborough 002,E02005368,2660,2073,1256,817,20,20,162,12,150,405,329,76,0
2021,Harborough 003,E02005369,5256,3936,2089,1847,129,129,521,38,483,669,582,87,1
2021,Harborough 004,E02005370,3898,3126,1520,1606,80,80,242,26,216,450,393,57,0
2021,Harborough 005,E02005371,4416,3515,1866,1649,48,48,279,31,248,574,480,94,0
2021,Harborough 006,E02005372,4146,3353,1858,1495,39,39,308,53,255,445,357,88,1
2021,Harborough 007,E02005373,4888,4041,2175,1866,77,77,215,25,190,555,480,75,0
2021,Harborough 008,E02005374,3050,1656,959,697,69,69,754,114,640,568,509,59,3
2021,Harborough 009,E02005375,4044,2926,1557,1369,104,104,210,12,198,804,719,85,0
2021,Harborough 010,E02005376,4560,3145,1698,1447,127,127,628,76,552,660,580,80,0
2021,Hinckley and Bosworth 001,E02005377,3908,3045,1690,1355,34,34,416,223,193,409,346,63,4
2021,Hinckley and Bosworth 002,E02005378,2242,1853,1018,835,24,24,118,75,43,247,213,34,0
2021,Hinckley and Bosworth 003,E02005379,2641,2086,1189,897,33,33,247,145,102,274,226,48,1
2021,Hinckley and Bosworth 004,E02005380,3695,2856,1697,1159,16,16,312,201,111,505,400,105,6
2021,Hinckley and Bosworth 005,E02005381,3677,2942,1676,1266,33,33,387,260,127,312,260,52,3
2021,Hinckley and Bosworth 006,E02005382,4653,3137,1637,1500,57,57,700,424,276,756,676,80,3
2021,Hinckley and Bosworth 007,E02005383,4071,2805,1437,1368,28,28,543,323,220,690,625,65,5
2021,Hinckley and Bosworth 008,E02005384,3031,2447,1356,1091,25,25,194,92,102,364,310,54,1
2021,Hinckley and Bosworth 009,E02005385,2846,2447,1355,1092,31,31,105,21,84,263,227,36,0
2021,Hinckley and Bosworth 010,E02005386,4305,2566,1255,1311,37,37,427,257,170,1271,1166,105,4
2021,Hinckley and Bosworth 011,E02005387,4316,3127,1431,1696,36,36,435,203,232,717,616,101,1
2021,Hinckley and Bosworth 012,E02005388,2814,1822,896,926,36,36,445,255,190,508,445,63,3
2021,Hinckley and Bosworth 013,E02005389,2698,1844,1065,779,4,4,537,462,75,302,252,50,11
2021,Hinckley and Bosworth 014,E02005390,4554,3812,2011,1801,58,58,183,63,120,500,437,63,1
2021,Melton 001,E02005391,4205,3164,1867,1297,51,51,322,246,76,662,573,89,6
2021,Melton 002,E02005392,4055,3177,1811,1366,29,29,218,89,129,630,557,73,1
2021,Melton 003,E02005393,3264,2459,1355,1104,37,37,337,232,105,429,343,86,2
2021,Melton 004,E02005394,4156,2466,1325,1141,88,88,859,531,328,735,653,82,8
2021,Melton 005,E02005395,3971,2670,1540,1130,13,13,488,434,54,796,709,87,4
2021,Melton 006,E02005396,2946,2095,1262,833,31,31,191,109,82,628,545,83,1
2021,North West Leicestershire 001,E02005397,4090,2971,1548,1423,42,42,424,317,107,651,591,60,2
2021,North West Leicestershire 002,E02005398,2959,1992,1120,872,24,24,288,202,86,650,596,54,5
2021,North West Leicestershire 003,E02005399,3642,2485,1191,1294,69,69,493,168,325,594,539,55,1
2021,North West Leicestershire 004,E02005400,2586,1978,1184,794,33,33,337,254,83,237,193,44,1
2021,North West Leicestershire 005,E02005401,2706,2198,1231,967,26,26,248,183,65,232,195,37,2
2021,North West Leicestershire 006,E02005402,2889,2116,1177,939,46,46,434,365,69,289,262,27,4
2021,North West Leicestershire 007,E02005403,2992,2324,1312,1012,11,11,303,255,48,353,321,32,1
2021,North West Leicestershire 008,E02005404,3690,2765,1377,1388,19,19,550,431,119,351,283,68,5
2021,North West Leicestershire 009,E02005405,3005,1783,1051,732,8,8,1020,699,321,188,161,27,6
2021,North West Leicestershire 010,E02005406,3376,1897,884,1013,54,54,576,248,328,847,781,66,2
2021,North West Leicestershire 011,E02005407,4546,3603,1444,2159,76,76,276,105,171,589,517,72,2
2021,North West Leicestershire 012,E02005408,3381,2401,1275,1126,16,16,452,371,81,510,441,69,2
2021,North West Leicestershire 013,E02005409,5112,3775,1804,1971,55,55,689,467,222,584,507,77,9
2021,Oadby and Wigston 003,E02005412,3560,2602,1599,1003,11,11,323,208,115,619,545,74,5
2021,Oadby and Wigston 005,E02005414,3472,2139,1093,1046,44,44,749,587,162,524,462,62,16
2021,Oadby and Wigston 006,E02005415,3572,2252,1215,1037,58,58,434,174,260,825,760,65,3
2021,Oadby and Wigston 007,E02005416,3907,3316,1996,1320,23,23,98,37,61,469,417,52,1
2021,Boston 001,E02005417,3089,2261,1456,805,39,39,481,126,355,305,233,72,3
2021,Boston 002,E02005418,4455,1448,738,710,48,48,1698,727,971,1244,1173,71,17
2021,Boston 003,E02005419,3788,1458,825,633,38,38,574,166,408,1716,1608,108,2
2021,Boston 004,E02005420,3740,1953,1026,927,47,47,985,304,681,749,709,40,6
2021,Boston 006,E02005422,2876,2073,1194,879,33,33,454,136,318,316,259,57,0
2021,Boston 007,E02005423,4387,2692,1512,1180,55,55,1050,351,699,588,525,63,2
2021,East Lindsey 001,E02005424,4524,3638,2265,1373,34,34,249,34,215,603,491,112,0
2021,East Lindsey 002,E02005425,2856,2312,1541,771,12,12,188,34,154,344,263,81,0
2021,East Lindsey 003,E02005426,4600,2751,1576,1175,90,90,1080,251,829,674,591,83,5
2021,East Lindsey 004,E02005427,3484,2070,1349,721,28,28,313,65,248,1073,972,101,0
2021,East Lindsey 005,E02005428,3930,2609,2008,601,43,43,576,101,475,700,582,118,2
2021,East Lindsey 006,E02005429,3194,2462,2063,399,18,18,189,32,157,524,444,80,1
2021,East Lindsey 007,E02005430,3142,2428,1672,756,14,14,183,39,144,516,410,106,1
2021,East Lindsey 008,E02005431,3986,2812,2023,789,32,32,416,88,328,726,602,124,0
2021,East Lindsey 009,E02005432,3463,2560,1749,811,25,25,175,38,137,702,536,166,1
2021,East Lindsey 010,E02005433,3409,2337,1917,420,35,35,293,65,228,743,596,147,1
2021,East Lindsey 011,E02005434,3540,2302,1462,840,48,48,482,97,385,707,610,97,1
2021,East Lindsey 012,E02005435,3641,2214,1512,702,66,66,344,66,278,1015,941,74,2
2021,East Lindsey 013,E02005436,3670,2519,1739,780,38,38,426,87,339,687,569,118,0
2021,East Lindsey 014,E02005437,2943,1162,738,424,10,10,225,17,208,1546,1448,98,0
2021,East Lindsey 015,E02005438,3226,1539,1018,521,73,73,1084,267,817,529,469,60,1
2021,East Lindsey 016,E02005439,5053,3496,2231,1265,89,89,440,77,363,1026,711,315,2
2021,East Lindsey 017,E02005440,2381,1564,1124,440,14,14,376,84,292,427,328,99,0
2021,East Lindsey 018,E02005441,3713,2871,1920,951,17,17,258,52,206,567,408,159,0
2021,Lincoln 001,E02005442,2944,1156,573,583,61,61,1355,1270,85,351,298,53,21
2021,Lincoln 002,E02005443,3381,2009,1056,953,22,22,665,557,108,677,617,60,8
2021,Lincoln 003,E02005444,5786,3168,1767,1401,65,65,547,395,152,1993,1797,196,13
2021,Lincoln 004,E02005445,5105,1810,803,1007,58,58,1692,1460,232,1522,1415,107,23
2021,Lincoln 005,E02005446,3067,936,507,429,21,21,520,373,147,1578,1505,73,12
2021,Lincoln 006,E02005447,3567,977,476,501,18,18,543,325,218,2014,1913,101,15
2021,Lincoln 007,E02005448,3167,1516,696,820,21,21,1056,873,183,562,507,55,12
2021,Lincoln 008,E02005449,3296,1914,957,957,65,65,379,145,234,935,860,75,3
2021,Lincoln 009,E02005450,3800,2899,1671,1228,13,13,230,145,85,657,582,75,1
2021,Lincoln 010,E02005451,3577,1433,629,804,29,29,1395,1261,134,693,636,57,27
2021,Lincoln 011,E02005452,4821,3648,1957,1691,14,14,573,360,213,578,506,72,8
2021,North Kesteven 001,E02005453,4756,4000,2396,1604,20,20,103,50,53,633,526,107,0
2021,North Kesteven 003,E02005455,5988,4666,2251,2415,70,70,347,272,75,903,732,171,2
2021,North Kesteven 004,E02005456,4561,2966,1536,1430,89,89,600,387,213,899,567,332,7
2021,North Kesteven 005,E02005457,3804,2788,1491,1297,44,44,470,381,89,493,392,101,9
2021,North Kesteven 006,E02005458,2950,2287,1408,879,34,34,277,225,52,347,265,82,5
2021,North Kesteven 007,E02005459,3629,2392,1401,991,15,15,709,651,58,500,398,102,13
2021,North Kesteven 008,E02005460,2440,1594,878,716,9,9,131,101,30,701,316,385,5
2021,North Kesteven 009,E02005461,2943,2257,1467,790,2,2,258,208,50,424,340,84,2
2021,North Kesteven 010,E02005462,4540,2566,1331,1235,62,62,890,596,294,1009,898,111,13
2021,North Kesteven 011,E02005463,4119,3036,1479,1557,94,94,275,101,174,713,578,135,1
2021,North Kesteven 012,E02005464,3868,2903,1814,1089,13,13,454,379,75,494,389,105,4
2021,South Holland 001,E02005465,3752,2874,1807,1067,33,33,454,366,88,385,296,89,6
2021,South Holland 002,E02005466,2895,2222,1434,788,15,15,321,233,88,335,258,77,2
2021,South Holland 003,E02005467,3532,2298,1406,892,34,34,484,339,145,712,636,76,4
2021,South Holland 004,E02005468,3246,2519,1569,950,34,34,351,286,65,337,258,79,5
2021,South Holland 005,E02005469,3306,2442,1319,1123,53,53,432,341,91,371,312,59,8
2021,South Holland 006,E02005470,5497,3361,1675,1686,100,100,506,270,236,1521,1421,100,9
2021,South Holland 007,E02005471,3905,2160,1287,873,14,14,861,735,126,855,780,75,15
2021,South Holland 008,E02005472,4460,2973,1863,1110,24,24,658,486,172,795,688,107,10
2021,South Holland 009,E02005473,4026,2744,1537,1207,71,71,301,189,112,908,833,75,2
2021,South Holland 010,E02005474,3052,2455,1547,908,23,23,214,185,29,356,278,78,4
2021,South Holland 011,E02005475,3031,2273,1160,1113,37,37,352,263,89,366,293,73,3
2021,South Kesteven 001,E02005476,3095,2416,1394,1022,20,20,277,225,52,381,300,81,1
2021,South Kesteven 002,E02005477,4030,3176,2025,1151,33,33,400,291,109,415,327,88,6
2021,South Kesteven 003,E02005478,4373,2741,1594,1147,20,20,942,805,137,649,565,84,21
2021,South Kesteven 004,E02005479,4377,3151,1563,1588,37,37,333,192,141,852,773,79,4
2021,South Kesteven 005,E02005480,2932,1403,670,733,12,12,1047,904,143,457,415,42,13
2021,South Kesteven 006,E02005481,5589,2840,1360,1480,70,70,663,316,347,2006,1876,130,10
2021,South Kesteven 007,E02005482,4163,3091,1729,1362,11,11,217,142,75,840,702,138,4
2021,South Kesteven 008,E02005483,3373,2507,1415,1092,20,20,364,300,64,479,384,95,3
2021,South Kesteven 009,E02005484,3183,2026,1106,920,29,29,476,293,183,649,567,82,3
2021,South Kesteven 010,E02005485,3544,2715,1366,1349,63,63,217,128,89,547,487,60,2
2021,South Kesteven 011,E02005486,4171,2672,1395,1277,91,91,545,339,206,857,785,72,6
2021,South Kesteven 012,E02005487,4151,3465,2129,1336,23,23,239,186,53,423,346,77,1
2021,South Kesteven 013,E02005488,3112,2265,1300,965,28,28,448,184,264,366,320,46,5
2021,South Kesteven 014,E02005489,3130,2378,1265,1113,43,43,227,131,96,478,420,58,4
2021,South Kesteven 015,E02005490,4177,2513,1350,1163,69,69,868,739,129,717,630,87,10
2021,South Kesteven 016,E02005491,5444,3559,2101,1458,82,82,588,362,226,1209,1104,105,6
2021,West Lindsey 001,E02005492,4381,3113,1927,1186,23,23,467,99,368,776,638,138,2
2021,West Lindsey 002,E02005493,4333,3375,1881,1494,31,31,314,105,209,613,526,87,0
2021,West Lindsey 003,E02005494,4511,3142,2003,1139,33,33,413,87,326,919,798,121,4
2021,West Lindsey 004,E02005495,5060,2429,1386,1043,36,36,688,128,560,1903,1795,108,4
2021,West Lindsey 005,E02005496,2785,1967,1161,806,10,10,181,42,139,627,513,114,0
2021,West Lindsey 006,E02005497,3140,1415,735,680,33,33,1253,485,768,433,384,49,6
2021,West Lindsey 007,E02005498,3371,2785,1790,995,10,10,215,50,165,361,265,96,0
2021,West Lindsey 008,E02005499,3635,2872,1690,1182,66,66,253,52,201,443,353,90,1
2021,West Lindsey 009,E02005500,3285,2397,1342,1055,65,65,238,40,198,584,423,161,1
2021,West Lindsey 010,E02005501,3552,2908,1715,1193,39,39,201,40,161,403,321,82,1
2021,West Lindsey 011,E02005502,4291,3352,1923,1429,46,46,385,62,323,506,414,92,2
2021,Breckland 001,E02005503,3124,2267,1430,837,14,14,309,64,245,533,357,176,1
2021,Breckland 002,E02005504,3991,2895,1905,990,24,24,487,85,402,585,456,129,0
2021,Breckland 003,E02005505,3225,2209,1261,948,28,28,508,97,411,478,404,74,2
2021,Breckland 004,E02005506,3010,2240,1388,852,12,12,286,54,232,472,377,95,0
2021,Breckland 005,E02005507,5281,3216,1904,1312,27,27,855,182,673,1180,1063,117,3
2021,Breckland 006,E02005508,3059,2394,1461,933,22,22,308,45,263,335,228,107,0
2021,Breckland 007,E02005509,3971,2540,1720,820,28,28,755,114,641,648,554,94,0
2021,Breckland 008,E02005510,3270,2411,1602,809,9,9,426,77,349,423,324,99,1
2021,Breckland 009,E02005511,4001,2773,1749,1024,42,42,406,73,333,776,675,101,4
2021,Breckland 010,E02005512,3748,2670,1492,1178,43,43,373,65,308,661,530,131,1
2021,Breckland 011,E02005513,4676,3096,1677,1419,85,85,593,110,483,900,786,114,2
2021,Breckland 012,E02005514,3042,2190,1359,831,8,8,351,61,290,493,404,89,0
2021,Breckland 013,E02005515,2671,2016,1155,861,7,7,192,11,181,456,370,86,0
2021,Breckland 014,E02005516,3001,2197,1344,853,11,11,281,54,227,512,391,121,0
2021,Breckland 015,E02005517,2345,867,402,465,12,12,917,223,694,544,506,38,5
2021,Breckland 016,E02005518,4532,2858,1442,1416,48,48,273,39,234,1353,1231,122,0
2021,Breckland 017,E02005519,3410,1622,835,787,14,14,1186,300,886,585,532,53,3
2021,Broadland 001,E02005520,4077,2901,1874,1027,40,40,572,62,510,564,469,95,0
2021,Broadland 002,E02005521,3801,2682,1710,972,22,22,412,51,361,685,559,126,0
2021,Broadland 003,E02005522,2363,1733,1052,681,18,18,244,33,211,368,315,53,0
2021,Broadland 004,E02005523,3516,2689,1469,1220,39,39,337,42,295,451,371,80,0
2021,Broadland 005,E02005524,2374,1962,1196,766,15,15,185,17,168,212,175,37,0
2021,Broadland 006,E02005525,4176,3335,1869,1466,28,28,269,40,229,544,479,65,0
2021,Broadland 007,E02005526,2307,1703,969,734,15,15,192,18,174,397,359,38,0
2021,Broadland 008,E02005527,3813,3053,1717,1336,52,52,377,31,346,328,270,58,3
2021,Broadland 009,E02005528,3806,3001,1772,1229,10,10,356,37,319,439,360,79,0
2021,Broadland 010,E02005529,2619,2103,1402,701,4,4,286,31,255,225,173,52,1
2021,Broadland 011,E02005530,2388,2021,1187,834,14,14,86,12,74,267,215,52,0
2021,Broadland 012,E02005531,2365,1763,1026,737,11,11,323,42,281,266,228,38,2
2021,Broadland 013,E02005532,4357,3496,1936,1560,76,76,333,35,298,451,383,68,1
2021,Broadland 014,E02005533,3919,2982,1782,1200,58,58,491,54,437,387,310,77,1
2021,Broadland 015,E02005534,3400,2710,1669,1041,11,11,383,57,326,296,239,57,0
2021,Broadland 016,E02005535,3056,2281,1234,1047,21,21,241,30,211,512,461,51,1
2021,Broadland 017,E02005536,2717,2165,1325,840,35,35,197,19,178,320,270,50,0
2021,Broadland 018,E02005537,2702,1955,1259,696,27,27,336,40,296,382,314,68,2
2021,Great Yarmouth 001,E02005538,4345,3540,2391,1149,20,20,265,216,49,519,398,121,1
2021,Great Yarmouth 002,E02005539,3416,2705,1735,970,8,8,281,247,34,419,318,101,3
2021,Great Yarmouth 003,E02005540,4164,3211,2215,996,14,14,292,235,57,642,529,113,5
2021,Great Yarmouth 004,E02005541,2549,1461,891,570,2,2,541,475,66,538,479,59,7
2021,Great Yarmouth 005,E02005542,3395,1084,667,417,17,17,748,429,319,1537,1453,84,9
2021,Great Yarmouth 006,E02005543,4157,1078,694,384,15,15,1258,989,269,1782,1700,82,24
2021,Great Yarmouth 007,E02005544,3114,1418,726,692,5,5,648,404,244,1038,978,60,5
2021,Great Yarmouth 008,E02005545,2845,2366,1471,895,15,15,144,105,39,320,258,62,0
2021,Great Yarmouth 009,E02005546,3742,1894,1065,829,13,13,1124,997,127,692,615,77,19
2021,Great Yarmouth 010,E02005547,3807,2519,1540,979,7,7,279,196,83,997,900,97,5
2021,Great Yarmouth 011,E02005548,3095,1559,844,715,5,5,1120,854,266,393,296,97,18
2021,Great Yarmouth 012,E02005549,2481,2041,1303,738,4,4,110,98,12,322,261,61,4
2021,Great Yarmouth 013,E02005550,3433,2643,1437,1206,8,8,399,216,183,378,318,60,5
2021,King's Lynn and West Norfolk 001,E02005551,2697,1835,1466,369,15,15,309,36,273,534,469,65,4
2021,King's Lynn and West Norfolk 002,E02005552,3129,2047,1477,570,20,20,487,108,379,572,449,123,3
2021,King's Lynn and West Norfolk 003,E02005553,4254,3212,2446,766,15,15,405,52,353,620,500,120,2
2021,King's Lynn and West Norfolk 004,E02005554,3331,2269,1618,651,15,15,351,58,293,694,540,154,2
2021,King's Lynn and West Norfolk 005,E02005555,2843,2458,1552,906,8,8,107,14,93,270,228,42,0
2021,King's Lynn and West Norfolk 006,E02005556,3326,2584,1378,1206,22,22,250,63,187,470,406,64,0
2021,King's Lynn and West Norfolk 007,E02005557,2747,1005,443,562,13,13,1089,370,719,633,573,60,7
2021,King's Lynn and West Norfolk 008,E02005558,3049,2372,1473,899,5,5,352,59,293,320,246,74,0
2021,King's Lynn and West Norfolk 009,E02005559,3065,1831,961,870,16,16,547,183,364,668,589,79,3
2021,King's Lynn and West Norfolk 010,E02005560,3669,1789,821,968,51,51,852,223,629,974,892,82,3
2021,King's Lynn and West Norfolk 011,E02005561,5257,2050,1098,952,45,45,1421,372,1049,1727,1604,123,14
2021,King's Lynn and West Norfolk 012,E02005562,3309,2362,1504,858,9,9,406,86,320,529,424,105,3
2021,King's Lynn and West Norfolk 013,E02005563,3258,2618,1542,1076,4,4,288,64,224,346,257,89,2
2021,King's Lynn and West Norfolk 014,E02005564,3829,2787,1726,1061,13,13,269,69,200,760,429,331,0
2021,King's Lynn and West Norfolk 015,E02005565,3123,2344,1324,1020,8,8,296,72,224,473,375,98,2
2021,King's Lynn and West Norfolk 016,E02005566,4357,3281,1984,1297,12,12,434,99,335,625,484,141,5
2021,King's Lynn and West Norfolk 017,E02005567,5292,3515,2275,1240,28,28,599,96,503,1149,1017,132,1
2021,King's Lynn and West Norfolk 018,E02005568,3332,2448,1535,913,12,12,345,65,280,524,419,105,3
2021,King's Lynn and West Norfolk 019,E02005569,3591,2396,1430,966,11,11,369,76,293,814,581,233,1
2021,North Norfolk 001,E02005570,3416,2449,1885,564,8,8,293,38,255,666,547,119,0
2021,North Norfolk 002,E02005571,2832,1728,1368,360,26,26,561,116,445,516,391,125,1
2021,North Norfolk 003,E02005572,3859,2329,1762,567,24,24,495,56,439,1008,918,90,3
2021,North Norfolk 004,E02005573,2871,1985,1599,386,34,34,492,66,426,359,297,62,1
2021,North Norfolk 005,E02005574,3243,2510,1827,683,22,22,251,26,225,460,360,100,0
2021,North Norfolk 006,E02005575,3175,2282,1657,625,33,33,354,44,310,505,403,102,1
2021,North Norfolk 007,E02005576,3157,2264,1699,565,33,33,405,72,333,454,382,72,1
2021,North Norfolk 008,E02005577,2722,1945,1254,691,15,15,300,44,256,460,386,74,2
2021,North Norfolk 009,E02005578,2657,1649,1034,615,15,15,312,51,261,677,551,126,4
2021,North Norfolk 011,E02005580,3769,2433,1628,805,35,35,648,122,526,649,559,90,4
2021,North Norfolk 012,E02005581,3234,2317,1441,876,9,9,286,56,230,622,512,110,0
2021,North Norfolk 013,E02005582,3252,2182,1477,705,11,11,367,67,300,692,624,68,0
2021,North Norfolk 014,E02005583,4050,3045,2236,809,28,28,504,77,427,472,372,100,1
2021,Norwich 001,E02005584,4955,2305,1059,1246,13,13,1641,1254,387,992,890,102,4
2021,Norwich 002,E02005585,4862,1665,734,931,40,40,2257,1801,456,892,808,84,8
2021,Norwich 003,E02005586,5084,2455,1023,1432,30,30,787,638,149,1802,1656,146,10
2021,Norwich 004,E02005587,4285,2253,1214,1039,18,18,1512,1350,162,492,420,72,10
2021,Norwich 005,E02005588,5018,1693,838,855,34,34,1992,1302,690,1286,1202,84,13
2021,Norwich 006,E02005589,4943,1825,928,897,43,43,1928,1552,376,1136,1051,85,11
2021,Norwich 009,E02005592,4191,2269,1217,1052,10,10,230,99,131,1680,1570,110,2
2021,Norwich 010,E02005593,2893,968,624,344,54,54,1162,731,431,706,669,37,3
2021,Norwich 011,E02005594,5615,2433,1421,1012,38,38,1307,1037,270,1827,1688,139,10
2021,Norwich 012,E02005595,4125,2968,1954,1014,10,10,469,365,104,675,587,88,3
2021,Norwich 013,E02005596,4551,1994,1015,979,17,17,1757,1446,311,774,691,83,9
2021,South Norfolk 002,E02005598,4100,3076,1643,1433,69,69,360,51,309,595,497,98,0
2021,South Norfolk 003,E02005599,3102,2291,1215,1076,38,38,375,83,292,397,346,51,1
2021,South Norfolk 004,E02005600,2469,1891,1195,696,11,11,275,59,216,290,228,62,2
2021,South Norfolk 005,E02005601,2757,1811,1214,597,44,44,400,97,303,502,445,57,0
2021,South Norfolk 006,E02005602,5609,4262,2427,1835,53,53,629,132,497,663,559,104,2
2021,South Norfolk 007,E02005603,5274,3826,1739,2087,131,131,631,89,542,686,592,94,0
2021,South Norfolk 008,E02005604,3811,2850,1770,1080,20,20,457,102,355,484,400,84,0
2021,South Norfolk 009,E02005605,4501,3549,2004,1545,39,39,418,79,339,493,393,100,2
2021,South Norfolk 010,E02005606,2495,1953,1184,769,10,10,192,46,146,340,270,70,0
2021,South Norfolk 011,E02005607,4841,3689,2096,1593,51,51,496,105,391,605,491,114,0
2021,South Norfolk 012,E02005608,3325,2514,1620,894,13,13,365,75,290,433,330,103,0
2021,South Norfolk 013,E02005609,3481,2319,1508,811,80,80,514,93,421,566,502,64,2
2021,South Norfolk 014,E02005610,3528,2665,1695,970,41,41,350,82,268,472,387,85,0
2021,South Norfolk 015,E02005611,5099,3206,2043,1163,44,44,786,182,604,1061,958,103,2
2021,North Northamptonshire 002,E02005612,2980,1912,1000,912,35,35,522,331,191,501,448,53,10
2021,North Northamptonshire 003,E02005613,3795,2271,1116,1155,5,5,794,732,62,715,625,90,10
2021,North Northamptonshire 006,E02005614,5504,3667,1220,2447,49,49,716,471,245,1066,991,75,6
2021,North Northamptonshire 004,E02005615,3973,2492,1293,1199,51,51,793,699,94,632,547,85,5
2021,North Northamptonshire 005,E02005616,2418,1260,618,642,3,3,636,460,176,513,469,44,6
2021,North Northamptonshire 007,E02005617,4362,1971,1002,969,9,9,1300,1186,114,1068,985,83,14
2021,West Northamptonshire 001,E02005619,2573,2011,1091,920,25,25,201,42,159,336,266,70,0
2021,West Northamptonshire 002,E02005620,3486,2693,1389,1304,41,41,312,62,250,439,362,77,1
2021,West Northamptonshire 004,E02005621,3336,2597,1546,1051,36,36,397,58,339,306,255,51,0
2021,West Northamptonshire 005,E02005622,4090,3136,1673,1463,68,68,291,48,243,593,508,85,2
2021,West Northamptonshire 003,E02005623,4646,3610,1681,1929,129,129,470,100,370,436,351,85,1
2021,West Northamptonshire 010,E02005624,4751,3102,1279,1823,142,142,665,100,565,842,768,74,0
2021,West Northamptonshire 016,E02005625,4097,2352,1247,1105,20,20,920,208,712,804,721,83,1
2021,West Northamptonshire 022,E02005626,2891,1480,675,805,36,36,761,228,533,611,551,60,3
2021,West Northamptonshire 027,E02005627,3370,2354,1250,1104,40,40,581,102,479,395,335,60,0
2021,West Northamptonshire 042,E02005628,3633,2702,1375,1327,45,45,418,84,334,467,397,70,1
2021,North Northamptonshire 001,E02005629,2748,1946,1149,797,43,43,371,62,309,388,310,78,0
2021,North Northamptonshire 010,E02005630,4272,2934,1803,1131,69,69,517,86,431,752,624,128,0
2021,North Northamptonshire 011,E02005631,4700,3316,1608,1708,84,84,545,81,464,754,659,95,1
2021,North Northamptonshire 024,E02005632,2741,2112,1152,960,28,28,330,55,275,270,212,58,1
2021,North Northamptonshire 025,E02005633,4165,3026,1438,1588,48,48,509,78,431,580,506,74,2
2021,North Northamptonshire 027,E02005634,3957,2591,1179,1412,51,51,698,85,613,615,562,53,2
2021,North Northamptonshire 035,E02005635,3915,2874,1344,1530,36,36,438,67,371,566,492,74,1
2021,North Northamptonshire 034,E02005636,5104,3520,1738,1782,30,30,810,127,683,742,665,77,2
2021,North Northamptonshire 037,E02005637,4382,2229,1090,1139,58,58,937,131,806,1155,1060,95,3
2021,North Northamptonshire 039,E02005638,4100,3473,1855,1618,30,30,100,19,81,497,430,67,0
2021,North Northamptonshire 012,E02005639,2426,1827,1063,764,9,9,237,170,67,350,293,57,3
2021,North Northamptonshire 013,E02005640,4920,3643,1763,1880,76,76,466,256,210,730,653,77,5
2021,North Northamptonshire 014,E02005641,3779,2463,1270,1193,52,52,560,316,244,699,632,67,5
2021,North Northamptonshire 015,E02005642,3366,2586,1354,1232,24,24,125,41,84,630,563,67,1
2021,North Northamptonshire 016,E02005643,3540,1569,662,907,27,27,1327,1064,263,595,542,53,22
2021,North Northamptonshire 017,E02005644,3972,1571,659,912,32,32,354,100,254,2010,1898,112,5
2021,North Northamptonshire 018,E02005645,5606,2856,1359,1497,72,72,1066,546,520,1602,1494,108,10
2021,North Northamptonshire 019,E02005646,2721,2241,1347,894,12,12,76,16,60,392,345,47,0
2021,North Northamptonshire 022,E02005647,3278,1983,1031,952,48,48,717,438,279,516,459,57,14
2021,North Northamptonshire 021,E02005648,3815,3165,1474,1691,81,81,206,66,140,363,308,55,0
2021,West Northamptonshire 006,E02005650,2637,2000,958,1042,28,28,214,153,61,392,355,37,3
2021,West Northamptonshire 007,E02005651,2827,2372,1403,969,38,38,84,17,67,333,277,56,0
2021,West Northamptonshire 008,E02005652,2909,2175,1199,976,23,23,322,190,132,385,330,55,4
2021,West Northamptonshire 011,E02005653,3248,1647,660,987,33,33,814,629,185,747,690,57,7
2021,West Northamptonshire 009,E02005654,3265,1730,734,996,107,107,779,619,160,648,582,66,1
2021,West Northamptonshire 012,E02005655,2726,2026,1187,839,62,62,298,200,98,331,276,55,9
2021,West Northamptonshire 014,E02005656,2365,1004,433,571,46,46,815,650,165,493,464,29,7
2021,West Northamptonshire 013,E02005657,2968,2057,1119,938,64,64,318,60,258,529,475,54,0
2021,West Northamptonshire 015,E02005658,2735,1199,439,760,35,35,830,692,138,654,604,50,17
2021,West Northamptonshire 018,E02005659,2442,1748,871,877,13,13,351,223,128,323,272,51,7
2021,West Northamptonshire 026,E02005660,2591,1420,675,745,40,40,679,578,101,443,379,64,9
2021,West Northamptonshire 017,E02005661,2586,1318,520,798,15,15,789,641,148,459,408,51,5
2021,West Northamptonshire 019,E02005662,2780,1850,902,948,24,24,281,196,85,621,557,64,4
2021,West Northamptonshire 023,E02005663,2427,1958,980,978,14,14,53,21,32,402,366,36,0
2021,West Northamptonshire 025,E02005664,2571,1343,569,774,20,20,311,186,125,892,791,101,5
2021,West Northamptonshire 024,E02005665,3313,2290,1009,1281,33,33,309,168,141,674,599,75,7
2021,West Northamptonshire 021,E02005666,3404,1310,499,811,47,47,1449,1162,287,576,523,53,22
2021,West Northamptonshire 020,E02005667,2868,1843,939,904,25,25,578,396,182,414,354,60,8
2021,West Northamptonshire 028,E02005668,2740,2259,1239,1020,13,13,186,108,78,282,233,49,0
2021,West Northamptonshire 029,E02005669,2394,2095,1191,904,16,16,65,30,35,217,177,40,1
2021,West Northamptonshire 032,E02005670,4404,844,323,521,100,100,1590,1014,576,1838,1742,96,32
2021,West Northamptonshire 030,E02005671,3255,1623,741,882,26,26,211,54,157,1393,1297,96,2
2021,West Northamptonshire 031,E02005672,3587,1005,391,614,37,37,386,137,249,2150,2055,95,9
2021,West Northamptonshire 033,E02005673,3378,1692,827,865,65,65,451,317,134,1162,1065,97,8
2021,West Northamptonshire 034,E02005674,3901,1270,616,654,51,51,796,405,391,1772,1657,115,12
2021,West Northamptonshire 036,E02005675,2463,1309,480,829,41,41,675,507,168,433,390,43,5
2021,West Northamptonshire 038,E02005676,2432,1475,608,867,19,19,539,420,119,393,348,45,6
2021,West Northamptonshire 037,E02005677,3785,1983,921,1062,51,51,391,154,237,1354,1266,88,6
2021,West Northamptonshire 041,E02005679,3591,2684,1187,1497,12,12,78,45,33,816,762,54,1
2021,West Northamptonshire 044,E02005680,3029,2420,922,1498,9,9,163,75,88,436,402,34,1
2021,West Northamptonshire 040,E02005681,3600,2802,1599,1203,36,36,424,110,314,335,255,80,3
2021,West Northamptonshire 043,E02005682,3166,2336,1218,1118,50,50,350,77,273,428,360,68,2
2021,West Northamptonshire 046,E02005683,5966,4501,1990,2511,85,85,543,123,420,836,713,123,1
2021,West Northamptonshire 045,E02005684,3650,2797,1519,1278,33,33,296,55,241,522,431,91,2
2021,West Northamptonshire 047,E02005685,4308,2942,1304,1638,129,129,659,138,521,576,512,64,2
2021,West Northamptonshire 048,E02005686,3315,2535,1433,1102,21,21,322,79,243,437,347,90,0
2021,West Northamptonshire 049,E02005687,2744,2118,1044,1074,50,50,262,51,211,314,257,57,0
2021,West Northamptonshire 050,E02005688,3999,3020,1468,1552,105,105,398,66,332,476,398,78,0
2021,West Northamptonshire 051,E02005689,4178,3456,1296,2160,98,98,204,31,173,420,359,61,0
2021,West Northamptonshire 053,E02005690,2514,1560,762,798,23,23,404,77,327,527,469,58,0
2021,West Northamptonshire 052,E02005691,2802,1986,1129,857,39,39,349,76,273,428,324,104,0
2021,North Northamptonshire 026,E02005692,3143,2196,1197,999,33,33,476,144,332,437,361,76,1
2021,North Northamptonshire 028,E02005693,3324,2041,1028,1013,26,26,718,321,397,535,484,51,4
2021,North Northamptonshire 029,E02005694,3073,2614,1393,1221,7,7,74,14,60,378,335,43,0
2021,North Northamptonshire 030,E02005695,4112,1895,804,1091,119,119,465,76,389,1633,1536,97,0
2021,North Northamptonshire 031,E02005696,2584,1143,501,642,66,66,997,255,742,373,337,36,5
2021,North Northamptonshire 032,E02005697,3362,1339,706,633,67,67,956,293,663,995,911,84,5
2021,North Northamptonshire 033,E02005698,2416,1539,882,657,16,16,538,252,286,319,278,41,4
2021,North Northamptonshire 036,E02005699,3338,1951,792,1159,41,41,873,331,542,470,414,56,3
2021,North Northamptonshire 038,E02005700,4527,3556,2004,1552,40,40,382,103,279,548,457,91,1
2021,North Northamptonshire 040,E02005701,4836,3585,1955,1630,28,28,487,167,320,734,635,99,2
2021,Northumberland 004,E02005702,2961,1991,1342,649,25,25,276,117,159,669,479,190,0
2021,Northumberland 005,E02005703,3457,1836,1162,674,6,6,1011,625,386,602,500,102,2
2021,Northumberland 006,E02005704,5904,4169,2700,1469,34,34,973,665,308,726,582,144,2
2021,Northumberland 007,E02005705,3584,2449,1712,737,24,24,366,193,173,745,569,176,0
2021,Northumberland 001,E02005706,4379,2298,1476,822,30,30,1205,412,793,843,737,106,3
2021,Northumberland 002,E02005707,3263,2319,1644,675,15,15,326,82,244,601,483,118,2
2021,Northumberland 003,E02005708,4956,2872,2099,773,28,28,723,201,522,1330,1010,320,3
2021,Northumberland 022,E02005709,3076,1085,535,550,4,4,1537,1262,275,438,395,43,12
2021,Northumberland 023,E02005710,4515,2559,1276,1283,19,19,769,393,376,1158,1024,134,10
2021,Northumberland 024,E02005711,3596,1772,1026,746,7,7,1369,1099,270,440,370,70,8
2021,Northumberland 025,E02005712,4025,2637,1085,1552,31,31,795,630,165,558,477,81,4
2021,Northumberland 026,E02005713,2767,2456,1433,1023,18,18,42,26,16,250,201,49,1
2021,Northumberland 029,E02005715,4096,2100,1048,1052,38,38,1385,734,651,568,502,66,5
2021,Northumberland 030,E02005717,3547,2553,1543,1010,9,9,659,568,91,320,256,64,6
2021,Northumberland 031,E02005718,3098,2428,1569,859,4,4,183,116,67,482,416,66,1
2021,Northumberland 032,E02005719,4046,2468,1252,1216,44,44,928,687,241,597,527,70,9
2021,Northumberland 008,E02005720,5072,3410,2006,1404,17,17,901,294,607,739,616,123,5
2021,Northumberland 011,E02005721,2486,1663,923,740,19,19,434,133,301,370,328,42,0
2021,Northumberland 015,E02005722,4045,2993,1562,1431,34,34,288,61,227,730,591,139,0
2021,Northumberland 016,E02005723,3107,1828,1179,649,14,14,768,244,524,491,421,70,6
2021,Northumberland 018,E02005724,2860,2526,1585,941,10,10,97,46,51,227,181,46,0
2021,Northumberland 033,E02005725,3055,2491,1560,931,4,4,221,57,164,339,268,71,0
2021,Northumberland 034,E02005726,3133,2640,1646,994,2,2,131,43,88,360,264,96,0
2021,Northumberland 019,E02005727,2802,1760,1146,614,19,19,331,76,255,691,567,124,1
2021,Northumberland 037,E02005728,3161,2124,1457,667,13,13,432,152,280,592,476,116,0
2021,Northumberland 036,E02005729,2507,1832,1101,731,16,16,291,92,199,367,296,71,1
2021,Northumberland 035,E02005730,5980,3984,2581,1403,46,46,1027,373,654,919,793,126,4
2021,Northumberland 038,E02005731,4766,3124,1629,1495,19,19,1028,467,561,594,499,95,1
2021,Northumberland 040,E02005733,3724,2497,1676,821,45,45,441,135,306,739,608,131,2
2021,Northumberland 009,E02005734,2868,1590,1032,558,7,7,726,364,362,539,454,85,6
2021,Northumberland 010,E02005735,3493,1655,964,691,21,21,499,153,346,1315,1208,107,3
2021,Northumberland 013,E02005736,3937,1969,896,1073,16,16,1307,681,626,642,562,80,3
2021,Northumberland 017,E02005739,4217,2775,1629,1146,6,6,835,397,438,601,502,99,0
2021,Northumberland 020,E02005740,4727,2518,1352,1166,6,6,1161,605,556,1038,914,124,4
2021,Northumberland 021,E02005741,3785,2722,1468,1254,35,35,577,283,294,451,373,78,0
2021,Craven 001,E02005742,3452,2550,1733,817,12,12,312,64,248,575,453,122,3
2021,Craven 003,E02005744,3697,2692,1878,814,27,27,342,40,302,635,520,115,1
2021,Craven 005,E02005746,3167,2232,1339,893,31,31,407,84,323,495,439,56,2
2021,Craven 006,E02005747,3299,1811,1058,753,21,21,478,80,398,988,889,99,1
2021,Craven 007,E02005748,3475,2634,1477,1157,10,10,251,71,180,580,492,88,0
2021,Craven 008,E02005749,4401,3289,1935,1354,43,43,423,74,349,642,558,84,4
2021,Hambleton 001,E02005750,3663,2418,1598,820,42,42,735,103,632,468,380,88,0
2021,Hambleton 002,E02005751,3986,3282,2264,1018,19,19,242,21,221,443,338,105,0
2021,Hambleton 003,E02005752,3133,2263,1354,909,31,31,332,25,307,507,401,106,0
2021,Hambleton 005,E02005754,3336,2743,1820,923,30,30,174,16,158,389,266,123,0
2021,Hambleton 006,E02005755,3097,2083,1275,808,23,23,446,42,404,545,447,98,0
2021,Hambleton 007,E02005756,2530,1663,1076,587,6,6,154,17,137,707,362,345,0
2021,Hambleton 008,E02005757,4053,2659,1657,1002,26,26,356,32,324,1010,873,137,2
2021,Hambleton 009,E02005758,4025,2578,1530,1048,82,82,757,89,668,606,400,206,2
2021,Hambleton 010,E02005759,4301,3005,1976,1029,37,37,604,55,549,655,512,143,0
2021,Hambleton 011,E02005760,2529,1888,1074,814,13,13,229,18,211,399,295,104,0
2021,Harrogate 001,E02005761,2376,1663,1114,549,14,14,194,133,61,504,378,126,1
2021,Harrogate 002,E02005762,2585,1691,1055,636,27,27,241,76,165,623,446,177,3
2021,Harrogate 003,E02005763,2762,1863,1132,731,17,17,255,190,65,625,378,247,2
2021,Harrogate 004,E02005764,4695,3048,1845,1203,15,15,786,508,278,842,744,98,4
2021,Harrogate 005,E02005765,3146,2261,1322,939,55,55,321,157,164,509,435,74,0
2021,Harrogate 006,E02005766,2675,1962,1298,664,14,14,204,150,54,493,391,102,2
2021,Harrogate 007,E02005767,3061,2554,1523,1031,50,50,151,42,109,305,242,63,1
2021,Harrogate 008,E02005768,2775,2145,1153,992,57,57,176,48,128,396,276,120,1
2021,Harrogate 009,E02005769,3324,2037,1162,875,18,18,614,376,238,645,569,76,10
2021,Harrogate 010,E02005770,4129,3266,1846,1420,22,22,200,125,75,639,546,93,2
2021,Harrogate 011,E02005771,3537,2285,1092,1193,41,41,551,235,316,650,587,63,10
2021,Harrogate 012,E02005772,2511,2215,1390,825,10,10,42,24,18,244,201,43,0
2021,Harrogate 013,E02005773,4352,2053,947,1106,45,45,1180,896,284,1053,960,93,21
2021,Harrogate 014,E02005774,4159,2831,1478,1353,60,60,587,222,365,677,608,69,4
2021,Harrogate 015,E02005775,4845,2235,1287,948,15,15,392,63,329,2203,2057,146,0
2021,Harrogate 016,E02005776,3532,2682,1467,1215,65,65,289,157,132,495,401,94,1
2021,Harrogate 017,E02005777,3428,2893,1659,1234,23,23,165,77,88,342,287,55,5
2021,Harrogate 018,E02005778,2604,2063,1300,763,22,22,106,63,43,411,331,80,2
2021,Harrogate 019,E02005779,3635,2431,1541,890,10,10,135,59,76,1058,967,91,1
2021,Harrogate 020,E02005780,4570,3691,2143,1548,57,57,263,30,233,559,479,80,0
2021,Harrogate 021,E02005781,2462,2037,1180,857,13,13,169,108,61,242,194,48,1
2021,Richmondshire 001,E02005782,3399,2477,1623,854,6,6,225,175,50,688,514,174,3
2021,Richmondshire 002,E02005783,3881,2582,1702,880,35,35,569,375,194,687,566,121,8
2021,Richmondshire 003,E02005784,2382,1636,932,704,11,11,289,156,133,442,290,152,4
2021,Richmondshire 004,E02005785,4564,2127,873,1254,22,22,782,466,316,1628,736,892,5
2021,Richmondshire 005,E02005786,2769,1977,1495,482,18,18,214,91,123,558,395,163,2
2021,Richmondshire 006,E02005787,3949,2695,1896,799,27,27,360,188,172,860,639,221,7
2021,Ryedale 001,E02005788,2973,2078,1514,564,9,9,255,25,230,631,495,136,0
2021,Ryedale 002,E02005789,5015,3591,2550,1041,35,35,625,66,559,763,629,134,1
2021,Ryedale 003,E02005790,3115,2055,1451,604,37,37,323,28,295,699,528,171,1
2021,Ryedale 004,E02005791,2949,1803,1131,672,9,9,414,35,379,722,590,132,1
2021,Ryedale 007,E02005794,4138,2916,1874,1042,19,19,342,31,311,861,699,162,0
2021,Scarborough 001,E02005795,3405,1986,1366,620,36,36,643,108,535,736,625,111,4
2021,Scarborough 002,E02005796,2970,2021,1450,571,23,23,339,65,274,587,469,118,0
2021,Scarborough 003,E02005797,2819,1785,1164,621,33,33,592,103,489,409,338,71,0
2021,Scarborough 004,E02005798,3758,2938,2042,896,32,32,292,60,232,496,389,107,0
2021,Scarborough 005,E02005799,4207,3332,2204,1128,73,73,407,85,322,392,319,73,3
2021,Scarborough 006,E02005800,3848,1587,952,635,11,11,614,92,522,1632,1510,122,4
2021,Scarborough 007,E02005801,2384,1274,753,521,10,10,802,191,611,295,246,49,3
2021,Scarborough 008,E02005802,3534,1991,1060,931,8,8,177,12,165,1358,1256,102,0
2021,Scarborough 009,E02005803,4376,2671,1606,1065,38,38,763,111,652,902,805,97,2
2021,Scarborough 010,E02005804,4409,1960,1451,509,11,11,251,34,217,2187,2044,143,0
2021,Scarborough 011,E02005805,3657,2867,1788,1079,35,35,335,33,302,420,355,65,0
2021,Scarborough 012,E02005806,3378,1898,984,914,74,74,1084,232,852,322,272,50,0
2021,Scarborough 013,E02005807,2854,2252,1440,812,31,31,169,21,148,402,326,76,0
2021,Scarborough 014,E02005808,5521,3907,2901,1006,69,69,604,107,497,939,793,146,2
2021,Selby 001,E02005809,3406,2319,1258,1061,11,11,566,467,99,503,438,65,7
2021,Selby 002,E02005810,3851,3038,1583,1455,35,35,252,161,91,525,428,97,1
2021,Selby 003,E02005811,4104,3313,1659,1654,26,26,292,196,96,470,400,70,3
2021,Selby 004,E02005812,4860,3543,1548,1995,103,103,682,391,291,530,452,78,2
2021,Selby 005,E02005813,5910,2848,1092,1756,81,81,1529,802,727,1439,1332,107,13
2021,Selby 006,E02005814,3053,2232,1280,952,59,59,431,232,199,324,268,56,7
2021,Selby 007,E02005815,3763,3180,1783,1397,58,58,205,55,150,320,258,62,0
2021,Selby 008,E02005816,3635,2967,1471,1496,23,23,197,132,65,447,373,74,1
2021,Selby 009,E02005817,3285,2553,1403,1150,24,24,367,274,93,339,283,56,2
2021,Selby 010,E02005818,3688,2920,1512,1408,26,26,328,210,118,411,338,73,3
2021,Ashfield 001,E02005819,2790,1948,1191,757,4,4,384,282,102,451,407,44,3
2021,Ashfield 002,E02005820,2496,1987,1204,783,10,10,145,136,9,353,304,49,1
2021,Ashfield 003,E02005821,2979,1721,859,862,5,5,733,579,154,505,449,56,15
2021,Ashfield 004,E02005822,4318,2370,1121,1249,17,17,658,380,278,1262,1164,98,11
2021,Ashfield 005,E02005823,3278,1384,702,682,22,22,1247,1093,154,605,547,58,20
2021,Ashfield 006,E02005824,4201,3144,1750,1394,39,39,358,235,123,659,591,68,1
2021,Ashfield 007,E02005825,3259,2253,1304,949,6,6,497,371,126,496,436,60,7
2021,Ashfield 008,E02005826,2626,1271,638,633,3,3,772,619,153,560,495,65,20
2021,Ashfield 009,E02005827,3976,3094,1522,1572,14,14,285,212,73,583,499,84,0
2021,Ashfield 010,E02005828,3399,2668,1457,1211,8,8,281,232,49,439,387,52,3
2021,Ashfield 011,E02005829,2831,2125,1225,900,13,13,356,316,40,331,279,52,6
2021,Ashfield 012,E02005830,2692,2101,1249,852,11,11,200,133,67,379,308,71,1
2021,Ashfield 013,E02005831,4492,3307,1556,1751,25,25,556,337,219,601,524,77,3
2021,Ashfield 014,E02005832,4282,2313,1110,1203,14,14,668,449,219,1276,1179,97,11
2021,Ashfield 015,E02005833,3189,2734,1541,1193,9,9,113,61,52,333,278,55,0
2021,Ashfield 016,E02005834,3708,2335,1060,1275,22,22,877,699,178,463,415,48,11
2021,Bassetlaw 001,E02005835,4968,3370,1771,1599,22,22,815,609,206,750,666,84,11
2021,Bassetlaw 002,E02005836,4025,3184,1923,1261,20,20,380,278,102,440,343,97,1
2021,Bassetlaw 003,E02005837,3028,2355,1434,921,15,15,265,232,33,392,307,85,1
2021,Bassetlaw 004,E02005838,3671,2610,1488,1122,16,16,616,571,45,423,343,80,6
2021,Bassetlaw 005,E02005839,2995,2027,1193,834,6,6,572,492,80,383,338,45,7
2021,Bassetlaw 006,E02005840,3884,3041,1284,1757,10,10,301,225,76,530,469,61,2
2021,Bassetlaw 008,E02005842,4052,2663,1598,1065,12,12,638,497,141,732,656,76,7
2021,Bassetlaw 009,E02005843,3018,2002,948,1054,15,15,458,359,99,532,488,44,11
2021,Bassetlaw 010,E02005844,4028,2455,1214,1241,29,29,717,468,249,819,746,73,8
2021,Bassetlaw 012,E02005846,2946,1017,494,523,26,26,942,718,224,954,891,63,7
2021,Bassetlaw 013,E02005847,3129,2108,1211,897,12,12,289,194,95,720,641,79,0
2021,Bassetlaw 014,E02005848,2745,1947,1138,809,3,3,292,203,89,500,388,112,3
2021,Bassetlaw 015,E02005849,3940,3007,1825,1182,16,16,361,296,65,551,409,142,5
2021,Broxtowe 001,E02005850,2961,2400,1418,982,9,9,155,105,50,397,342,55,0
2021,Broxtowe 002,E02005851,2781,1490,804,686,41,41,795,581,214,444,393,51,11
2021,Broxtowe 003,E02005852,3711,3110,1803,1307,7,7,208,101,107,385,325,60,1
2021,Broxtowe 004,E02005853,4012,2998,1637,1361,10,10,527,412,115,470,408,62,7
2021,Broxtowe 007,E02005856,3126,2615,1613,1002,2,2,152,140,12,354,303,51,3
2021,Broxtowe 008,E02005857,2811,1868,977,891,9,9,459,400,59,465,408,57,10
2021,Broxtowe 009,E02005858,3111,1906,1042,864,3,3,420,278,142,781,722,59,1
2021,Broxtowe 010,E02005859,4098,2734,1430,1304,2,2,599,471,128,756,667,89,7
2021,Broxtowe 011,E02005860,4046,1891,1041,850,12,12,605,442,163,1529,1436,93,9
2021,Broxtowe 012,E02005861,2534,1564,830,734,13,13,275,118,157,682,647,35,0
2021,Broxtowe 013,E02005862,3357,2210,1268,942,7,7,659,624,35,470,303,167,11
2021,Broxtowe 014,E02005863,3211,2563,1496,1067,6,6,207,155,52,433,392,41,2
2021,Broxtowe 015,E02005864,3395,2790,1559,1231,20,20,86,59,27,498,454,44,1
2021,Gedling 001,E02005865,3659,3127,1842,1285,16,16,180,53,127,334,257,77,2
2021,Gedling 002,E02005866,4049,3102,1859,1243,19,19,370,125,245,556,458,98,2
2021,Gedling 004,E02005868,3117,2353,1267,1086,20,20,363,140,223,377,320,57,4
2021,Gedling 005,E02005869,2436,1423,732,691,17,17,665,269,396,328,285,43,3
2021,Gedling 006,E02005870,3013,1754,864,890,17,17,534,251,283,703,641,62,5
2021,Gedling 007,E02005871,3220,2555,1534,1021,15,15,141,29,112,505,441,64,4
2021,Gedling 008,E02005872,2871,2475,1446,1029,13,13,89,33,56,293,245,48,1
2021,Gedling 009,E02005873,4300,3647,2185,1462,7,7,57,23,34,589,531,58,0
2021,Gedling 010,E02005874,3778,3065,1604,1461,14,14,207,78,129,490,431,59,2
2021,Gedling 011,E02005875,3468,2640,1213,1427,33,33,427,181,246,366,301,65,2
2021,Gedling 012,E02005876,3744,2843,1502,1341,6,6,312,139,173,581,487,94,2
2021,Gedling 013,E02005877,3243,2332,1191,1141,12,12,214,91,123,685,602,83,0
2021,Gedling 014,E02005878,4539,2826,1530,1296,30,30,714,317,397,964,857,107,5
2021,Gedling 015,E02005879,3495,1934,828,1106,37,37,474,193,281,1050,965,85,0
2021,Mansfield 001,E02005880,2639,1692,1028,664,15,15,522,294,228,405,361,44,5
2021,Mansfield 002,E02005881,2664,1660,893,767,10,10,442,325,117,540,467,73,12
2021,Mansfield 003,E02005882,3427,2764,1642,1122,7,7,347,273,74,304,243,61,5
2021,Mansfield 004,E02005883,3604,1985,953,1032,50,50,890,679,211,661,591,70,18
2021,Mansfield 005,E02005884,2781,2016,1163,853,38,38,111,66,45,615,543,72,1
2021,Mansfield 006,E02005885,3891,2447,1308,1139,7,7,815,695,120,598,537,61,24
2021,Mansfield 007,E02005886,4737,3649,1909,1740,15,15,397,238,159,671,585,86,5
2021,Mansfield 008,E02005887,4588,1761,972,789,27,27,718,376,342,2078,1970,108,4
2021,Mansfield 009,E02005888,3830,1517,750,767,17,17,1243,910,333,1034,957,77,19
2021,Mansfield 010,E02005889,4563,2978,1647,1331,14,14,853,747,106,704,609,95,14
2021,Mansfield 011,E02005890,2851,2444,1387,1057,5,5,58,42,16,344,296,48,0
2021,Mansfield 012,E02005891,2836,1178,634,544,4,4,1353,1001,352,284,253,31,17
2021,Mansfield 013,E02005892,5622,4665,2382,2283,5,5,121,92,29,828,742,86,3
2021,Newark and Sherwood 001,E02005893,4934,3014,1594,1420,19,19,970,640,330,925,806,119,6
2021,Newark and Sherwood 002,E02005894,4893,3435,1603,1832,42,42,696,474,222,714,626,88,6
2021,Newark and Sherwood 003,E02005895,3533,2805,1778,1027,25,25,260,198,62,441,346,95,2
2021,Newark and Sherwood 004,E02005896,3387,2718,1722,996,24,24,303,238,65,339,268,71,3
2021,Newark and Sherwood 005,E02005897,3970,3012,1742,1270,19,19,519,362,157,416,315,101,4
2021,Newark and Sherwood 006,E02005898,4936,3392,1720,1672,39,39,744,404,340,756,638,118,5
2021,Newark and Sherwood 007,E02005899,5538,2567,1373,1194,65,65,1156,603,553,1738,1609,129,12
2021,Newark and Sherwood 008,E02005900,3215,2384,1564,820,32,32,331,236,95,465,382,83,3
2021,Newark and Sherwood 009,E02005901,4221,2652,1385,1267,52,52,524,359,165,989,896,93,4
2021,Newark and Sherwood 010,E02005902,3593,2162,1274,888,20,20,985,864,121,421,363,58,5
2021,Newark and Sherwood 011,E02005903,4629,3423,1845,1578,31,31,492,411,81,675,597,78,8
2021,Newark and Sherwood 012,E02005904,3951,3052,1566,1486,59,59,280,202,78,557,483,74,3
2021,Newark and Sherwood 013,E02005905,2527,2173,1358,815,9,9,154,139,15,189,145,44,2
2021,Rushcliffe 001,E02005906,2779,2244,1363,881,21,21,182,26,156,331,261,70,1
2021,Rushcliffe 002,E02005907,4410,3235,1693,1542,41,41,487,94,393,644,560,84,3
2021,Rushcliffe 003,E02005908,4104,3333,1965,1368,34,34,297,70,227,438,353,85,2
2021,Rushcliffe 004,E02005909,3262,2509,1173,1336,15,15,126,21,105,611,565,46,1
2021,Rushcliffe 005,E02005910,3924,1998,932,1066,15,15,365,40,325,1545,1470,75,1
2021,Rushcliffe 006,E02005911,3514,2682,1479,1203,41,41,163,22,141,628,575,53,0
2021,Rushcliffe 007,E02005912,3910,3031,1660,1371,39,39,268,55,213,572,505,67,0
2021,Rushcliffe 008,E02005913,3457,2525,1263,1262,92,92,490,87,403,347,306,41,3
2021,Rushcliffe 009,E02005914,3425,2458,1158,1300,73,73,541,153,388,353,299,54,0
2021,Rushcliffe 010,E02005915,2488,2021,1199,822,26,26,186,31,155,255,204,51,0
2021,Rushcliffe 011,E02005916,3326,2455,1199,1256,29,29,385,108,277,454,397,57,3
2021,Rushcliffe 012,E02005917,2531,2300,1478,822,12,12,33,6,27,186,149,37,0
2021,Rushcliffe 013,E02005918,2318,1791,1131,660,23,23,236,69,167,268,229,39,0
2021,Rushcliffe 014,E02005919,2759,2061,1110,951,24,24,322,75,247,352,294,58,0
2021,Rushcliffe 015,E02005920,3688,3115,1702,1413,40,40,199,32,167,333,286,47,1
2021,Cherwell 001,E02005921,2966,2248,1141,1107,74,74,294,56,238,350,296,54,0
2021,Cherwell 002,E02005922,3628,2225,935,1290,46,46,468,79,389,889,815,74,0
2021,Cherwell 003,E02005923,2338,1222,562,660,34,34,578,114,464,498,449,49,6
2021,Cherwell 004,E02005924,5631,2269,969,1300,125,125,911,158,753,2324,2199,125,2
2021,Cherwell 005,E02005925,3266,1572,763,809,24,24,1280,270,1010,387,336,51,3
2021,Cherwell 006,E02005926,3870,2711,1599,1112,59,59,435,83,352,663,598,65,2
2021,Cherwell 007,E02005927,2435,1662,882,780,27,27,233,20,213,513,470,43,0
2021,Cherwell 008,E02005928,4377,3258,1576,1682,146,146,486,34,452,486,416,70,1
2021,Cherwell 009,E02005929,3122,2371,1396,975,35,35,322,38,284,394,305,89,0
2021,Cherwell 010,E02005930,3854,2667,1397,1270,115,115,348,43,305,724,648,76,0
2021,Cherwell 011,E02005931,4344,2897,1231,1666,104,104,399,53,346,944,596,348,0
2021,Cherwell 012,E02005932,2683,1791,681,1110,9,9,210,25,185,673,625,48,0
2021,Cherwell 013,E02005933,3101,2099,984,1115,32,32,406,66,340,563,524,39,1
2021,Cherwell 014,E02005934,3523,2555,1380,1175,18,18,516,87,429,433,380,53,1
2021,Cherwell 015,E02005935,3774,2123,900,1223,124,124,471,54,417,1056,967,89,0
2021,Cherwell 016,E02005936,4896,3547,1587,1960,133,133,588,68,520,627,503,124,1
2021,Cherwell 017,E02005937,2929,2031,1306,725,28,28,328,119,209,533,469,64,9
2021,Cherwell 018,E02005938,2254,1591,944,647,13,13,234,33,201,416,362,54,0
2021,Cherwell 019,E02005939,2899,2001,1198,803,102,102,235,26,209,561,494,67,0
2021,Oxford 001,E02005940,2603,1681,1028,653,31,31,356,263,93,532,492,40,3
2021,Oxford 002,E02005941,2748,1479,976,503,19,19,395,259,136,854,718,136,1
2021,Oxford 003,E02005942,2285,1348,926,422,35,35,170,51,119,732,635,97,0
2021,Oxford 004,E02005943,2639,1584,971,613,13,13,277,234,43,762,695,67,3
2021,Oxford 005,E02005944,3112,1088,533,555,49,49,1256,960,296,711,659,52,8
2021,Oxford 006,E02005945,3843,1922,1177,745,38,38,459,206,253,1421,1260,161,3
2021,Oxford 007,E02005946,3395,2014,1049,965,20,20,357,242,115,1002,918,84,2
2021,Oxford 008,E02005947,2477,669,434,235,30,30,471,190,281,1304,1098,206,3
2021,Oxford 009,E02005948,2735,1048,631,417,20,20,425,271,154,1241,1123,118,1
2021,Oxford 010,E02005949,2459,703,367,336,27,27,958,699,259,761,708,53,10
2021,Oxford 011,E02005950,3860,1261,768,493,20,20,606,255,351,1968,1852,116,5
2021,Oxford 012,E02005951,2422,1198,667,531,22,22,407,320,87,784,714,70,11
2021,Oxford 014,E02005953,2270,1026,558,468,16,16,357,298,59,869,805,64,2
2021,Oxford 015,E02005954,3864,2196,1193,1003,47,47,498,388,110,1111,1024,87,12
2021,Oxford 016,E02005955,4120,1771,858,913,72,72,1233,979,254,1035,956,79,9
2021,Oxford 017,E02005956,2395,909,415,494,39,39,1072,785,287,368,327,41,7
2021,Oxford 018,E02005957,2594,788,264,524,181,181,1265,494,771,355,323,32,5
2021,South Oxfordshire 001,E02005958,2334,1702,921,781,9,9,175,20,155,448,401,47,0
2021,South Oxfordshire 002,E02005959,2414,1818,1131,687,25,25,237,34,203,334,253,81,0
2021,South Oxfordshire 003,E02005960,3262,2241,1201,1040,87,87,524,56,468,410,335,75,0
2021,South Oxfordshire 004,E02005961,2876,2131,1291,840,12,12,275,30,245,458,375,83,0
2021,South Oxfordshire 005,E02005962,4118,3206,1622,1584,106,106,438,52,386,368,292,76,0
2021,South Oxfordshire 006,E02005963,3312,2367,1420,947,20,20,486,106,380,439,368,71,0
2021,South Oxfordshire 007,E02005964,3050,2427,1409,1018,27,27,240,34,206,354,286,68,2
2021,South Oxfordshire 008,E02005965,2338,1649,939,710,18,18,239,36,203,431,352,79,1
2021,South Oxfordshire 009,E02005966,3331,2199,794,1405,56,56,176,27,149,900,851,49,0
2021,South Oxfordshire 010,E02005967,3736,2288,941,1347,179,179,581,95,486,687,514,173,1
2021,South Oxfordshire 011,E02005968,2879,1778,987,791,27,27,269,40,229,805,369,436,0
2021,South Oxfordshire 012,E02005969,4195,2816,1517,1299,105,105,733,114,619,541,459,82,0
2021,South Oxfordshire 013,E02005970,2435,1352,642,710,23,23,472,89,383,588,554,34,0
2021,South Oxfordshire 014,E02005971,2602,1813,916,897,48,48,432,68,364,301,259,42,8
2021,South Oxfordshire 015,E02005972,4835,3346,1487,1859,263,263,652,91,561,572,470,102,2
2021,South Oxfordshire 016,E02005973,2783,1769,1116,653,26,26,387,62,325,600,531,69,1
2021,South Oxfordshire 017,E02005974,2802,1849,1060,789,19,19,330,38,292,604,553,51,0
2021,South Oxfordshire 018,E02005975,3273,2569,1534,1035,22,22,292,33,259,388,281,107,2
2021,South Oxfordshire 019,E02005976,2441,1912,1117,795,22,22,186,30,156,321,228,93,0
2021,South Oxfordshire 020,E02005977,2489,1963,1135,828,26,26,263,37,226,236,191,45,1
2021,Vale of White Horse 001,E02005978,3055,2317,1376,941,28,28,245,28,217,460,385,75,5
2021,Vale of White Horse 002,E02005979,4108,2909,1604,1305,39,39,345,50,295,815,700,115,0
2021,Vale of White Horse 003,E02005980,4190,2885,1768,1117,38,38,525,106,419,740,369,371,2
2021,Vale of White Horse 004,E02005981,3536,2900,1602,1298,17,17,135,23,112,484,435,49,0
2021,Vale of White Horse 005,E02005982,2424,1822,997,825,8,8,207,104,103,385,333,52,2
2021,Vale of White Horse 006,E02005983,5068,2647,1365,1282,64,64,1065,128,937,1285,1158,127,7
2021,Vale of White Horse 007,E02005984,3727,2776,1426,1350,97,97,406,55,351,448,348,100,0
2021,Vale of White Horse 008,E02005985,3393,2062,1173,889,45,45,866,155,711,415,351,64,5
2021,Vale of White Horse 009,E02005986,4230,2670,1375,1295,79,79,762,117,645,717,560,157,2
2021,Vale of White Horse 010,E02005987,4172,2926,1404,1522,91,91,758,110,648,397,329,68,0
2021,Vale of White Horse 011,E02005988,3816,2776,1348,1428,85,85,552,80,472,403,299,104,0
2021,Vale of White Horse 014,E02005991,4468,3064,1691,1373,83,83,657,88,569,663,564,99,1
2021,Vale of White Horse 015,E02005992,5681,3816,1771,2045,255,255,869,127,742,739,601,138,2
2021,West Oxfordshire 001,E02005993,3251,2120,1249,871,55,55,558,108,450,517,444,73,1
2021,West Oxfordshire 002,E02005994,2560,1755,1041,714,22,22,295,41,254,488,332,156,0
2021,West Oxfordshire 003,E02005995,2725,1930,1166,764,40,40,310,39,271,444,335,109,1
2021,West Oxfordshire 004,E02005996,3885,2629,1514,1115,66,66,462,47,415,728,623,105,0
2021,West Oxfordshire 005,E02005997,2621,1918,1192,726,42,42,353,35,318,307,251,56,1
2021,West Oxfordshire 006,E02005998,2922,2172,1277,895,65,65,274,27,247,411,332,79,0
2021,West Oxfordshire 007,E02005999,2719,2080,1261,819,40,40,261,42,219,338,249,89,0
2021,West Oxfordshire 008,E02006000,4976,3417,1767,1650,94,94,609,72,537,856,774,82,0
2021,West Oxfordshire 009,E02006001,2947,1856,792,1064,96,96,603,28,575,391,346,45,1
2021,West Oxfordshire 010,E02006002,4879,2862,1715,1147,181,181,838,82,756,997,880,117,1
2021,West Oxfordshire 011,E02006003,2541,1672,1003,669,49,49,436,91,345,384,327,57,0
2021,West Oxfordshire 012,E02006004,2643,1777,1021,756,54,54,342,41,301,469,347,122,1
2021,West Oxfordshire 013,E02006005,3872,2155,779,1376,105,105,380,37,343,1232,646,586,0
2021,West Oxfordshire 014,E02006006,2403,1464,868,596,19,19,275,36,239,645,412,233,0
2021,West Oxfordshire 015,E02006007,3030,2239,1318,921,67,67,361,60,301,361,281,80,2
2021,Shropshire 025,E02006008,4521,3075,1402,1673,93,93,731,352,379,618,520,98,4
2021,Shropshire 027,E02006009,2734,1813,1226,587,9,9,316,193,123,592,344,248,4
2021,Shropshire 029,E02006010,5176,3409,2191,1218,53,53,758,401,357,951,825,126,5
2021,Shropshire 031,E02006011,2635,1939,1242,697,15,15,294,167,127,385,325,60,2
2021,Shropshire 033,E02006012,2923,2013,1263,750,11,11,345,160,185,549,479,70,5
2021,Shropshire 034,E02006013,3239,2272,1419,853,14,14,278,154,124,669,547,122,6
2021,Shropshire 035,E02006014,4127,2985,2083,902,25,25,421,224,197,694,573,121,2
2021,Shropshire 001,E02006015,4575,2958,1798,1160,41,41,665,135,530,905,811,94,6
2021,Shropshire 002,E02006016,3408,2652,1626,1026,21,21,264,53,211,470,355,115,1
2021,Shropshire 004,E02006017,3540,2552,1679,873,14,14,324,58,266,649,569,80,1
2021,Shropshire 005,E02006018,5464,3551,2096,1455,36,36,903,206,697,972,877,95,2
2021,Shropshire 008,E02006019,2828,1919,1239,680,11,11,392,55,337,502,440,62,4
2021,Shropshire 009,E02006020,2595,1911,1097,814,17,17,263,49,214,404,271,133,0
2021,Shropshire 010,E02006021,3535,2787,1651,1136,41,41,285,43,242,422,334,88,0
2021,Shropshire 013,E02006022,2447,1688,957,731,32,32,258,32,226,469,306,163,0
2021,Shropshire 003,E02006023,4189,2973,1794,1179,22,22,662,360,302,526,409,117,6
2021,Shropshire 006,E02006024,4254,2639,1488,1151,39,39,905,468,437,661,580,81,10
2021,Shropshire 007,E02006025,4474,2691,1646,1045,26,26,589,241,348,1165,1057,108,3
2021,Shropshire 011,E02006026,3072,2326,1417,909,19,19,301,167,134,425,340,85,1
2021,Shropshire 012,E02006027,2296,1852,1174,678,14,14,143,77,66,287,213,74,0
2021,Shropshire 014,E02006028,4004,2867,1719,1148,39,39,462,88,374,635,532,103,1
2021,Shropshire 015,E02006029,3278,1864,1054,810,21,21,986,342,644,405,346,59,2
2021,Shropshire 016,E02006030,3388,2220,1025,1195,38,38,623,217,406,503,387,116,4
2021,Shropshire 017,E02006031,3840,2121,1105,1016,42,42,648,166,482,1025,937,88,4
2021,Shropshire 018,E02006032,3700,2250,1229,1021,44,44,993,290,703,408,353,55,5
2021,Shropshire 019,E02006033,4354,2340,1512,828,50,50,427,59,368,1536,1388,148,1
2021,Shropshire 020,E02006034,4699,3302,1768,1534,47,47,453,63,390,895,805,90,2
2021,Shropshire 021,E02006035,2729,2175,1453,722,13,13,237,64,173,302,253,49,2
2021,Shropshire 022,E02006036,3241,2150,1217,933,19,19,369,73,296,701,637,64,2
2021,Shropshire 023,E02006037,4078,3038,1826,1212,22,22,480,137,343,537,441,96,1
2021,Shropshire 024,E02006038,3597,2764,1611,1153,43,43,293,59,234,496,406,90,1
2021,Shropshire 026,E02006039,3550,2609,1654,955,40,40,481,127,354,418,326,92,2
2021,Shropshire 028,E02006040,3167,2287,1482,805,17,17,240,48,192,621,507,114,2
2021,Shropshire 030,E02006041,2516,1718,1256,462,16,16,271,24,247,510,408,102,1
2021,Shropshire 032,E02006042,2736,2065,1621,444,29,29,286,39,247,356,288,68,0
2021,Shropshire 036,E02006043,2948,1839,1317,522,19,19,337,45,292,752,611,141,1
2021,Shropshire 037,E02006044,2741,2067,1627,440,22,22,179,18,161,473,370,103,0
2021,Shropshire 038,E02006045,5103,3177,2307,870,80,80,917,115,802,929,806,123,0
2021,Shropshire 039,E02006046,3877,2929,1994,935,19,19,384,44,340,545,445,100,0
2021,Mendip 001,E02006047,3735,2759,1653,1106,26,26,312,70,242,637,518,119,1
2021,Mendip 002,E02006048,2916,2058,1219,839,23,23,434,72,362,400,334,66,1
2021,Mendip 003,E02006049,3185,2644,1659,985,7,7,39,9,30,495,457,38,0
2021,Mendip 004,E02006050,3952,2055,1068,987,64,64,973,211,762,859,775,84,1
2021,Mendip 005,E02006051,3520,2684,1741,943,49,49,297,47,250,490,375,115,0
2021,Mendip 006,E02006052,3289,2458,1438,1020,9,9,199,49,150,622,525,97,1
2021,Mendip 007,E02006053,4687,3049,1553,1496,64,64,743,208,535,826,732,94,5
2021,Mendip 008,E02006054,4142,2714,1853,861,78,78,530,92,438,818,719,99,2
2021,Mendip 009,E02006055,3966,2418,1237,1181,66,66,618,127,491,861,793,68,3
2021,Mendip 010,E02006056,3264,2424,1502,922,24,24,320,56,264,494,401,93,2
2021,Mendip 011,E02006057,3696,2318,1548,770,76,76,528,54,474,772,676,96,2
2021,Mendip 012,E02006058,3281,2567,1549,1018,31,31,200,26,174,483,388,95,0
2021,Mendip 013,E02006059,2876,2247,1474,773,18,18,155,24,131,456,319,137,0
2021,Mendip 014,E02006060,3787,2145,1165,980,68,68,705,103,602,866,757,109,3
2021,Sedgemoor 001,E02006061,4062,3035,1817,1218,62,62,400,198,202,561,480,81,4
2021,Sedgemoor 002,E02006062,4787,3945,2542,1403,35,35,179,102,77,628,533,95,0
2021,Sedgemoor 003,E02006063,2862,2405,1502,903,16,16,132,72,60,307,228,79,2
2021,Sedgemoor 004,E02006064,3761,2537,1727,810,16,16,306,161,145,899,803,96,3
2021,Sedgemoor 005,E02006065,3953,2330,1381,949,54,54,901,407,494,656,585,71,12
2021,Sedgemoor 006,E02006066,3663,2812,1709,1103,70,70,431,241,190,346,278,68,4
2021,Sedgemoor 007,E02006067,3074,2355,1518,837,17,17,259,155,104,443,338,105,0
2021,Sedgemoor 008,E02006068,3197,1499,751,748,28,28,1028,716,312,639,577,62,3
2021,Sedgemoor 009,E02006069,4873,2213,1109,1104,19,19,789,339,450,1848,1729,119,4
2021,Sedgemoor 010,E02006070,3808,2668,1221,1447,49,49,289,95,194,800,730,70,2
2021,Sedgemoor 011,E02006071,3916,2983,1557,1426,33,33,233,94,139,666,599,67,1
2021,Sedgemoor 012,E02006072,4015,3332,2106,1226,23,23,229,125,104,430,341,89,1
2021,Sedgemoor 013,E02006073,3239,1391,694,697,12,12,1182,700,482,641,580,61,13
2021,Sedgemoor 014,E02006074,4697,3317,1511,1806,59,59,527,215,312,791,694,97,3
2021,South Somerset 001,E02006075,2211,1488,933,555,21,21,253,48,205,448,342,106,1
2021,South Somerset 002,E02006076,4023,2948,1940,1008,56,56,426,63,363,593,453,140,0
2021,South Somerset 003,E02006077,2811,2030,1327,703,41,41,391,64,327,349,287,62,0
2021,South Somerset 004,E02006078,2797,2047,1317,730,28,28,290,53,237,431,359,72,1
2021,South Somerset 005,E02006079,3724,2425,1453,972,30,30,508,87,421,760,622,138,1
2021,South Somerset 006,E02006080,2512,1694,1018,676,22,22,278,44,234,516,310,206,2
2021,South Somerset 007,E02006081,2485,1895,1222,673,39,39,281,50,231,270,205,65,0
2021,South Somerset 008,E02006082,3147,2158,1322,836,39,39,457,61,396,493,419,74,0
2021,South Somerset 009,E02006083,2578,1888,1137,751,12,12,346,74,272,331,276,55,1
2021,South Somerset 010,E02006084,3416,2521,1718,803,31,31,403,68,335,459,355,104,2
2021,South Somerset 011,E02006085,3360,2253,1179,1074,66,66,476,115,361,563,425,138,2
2021,South Somerset 012,E02006086,3087,2337,1164,1173,23,23,293,58,235,433,366,67,1
2021,South Somerset 013,E02006087,2631,1364,734,630,45,45,563,134,429,652,543,109,7
2021,South Somerset 014,E02006088,3330,1633,858,775,60,60,1104,317,787,526,463,63,7
2021,South Somerset 015,E02006089,3413,1514,809,705,14,14,585,118,467,1300,1189,111,0
2021,South Somerset 016,E02006090,3087,1995,1056,939,37,37,447,107,340,604,529,75,4
2021,South Somerset 017,E02006091,4446,3234,2107,1127,53,53,619,141,478,540,418,122,0
2021,South Somerset 018,E02006092,2905,2304,1317,987,39,39,183,36,147,377,329,48,2
2021,South Somerset 019,E02006093,4008,2868,1808,1060,32,32,489,88,401,615,529,86,4
2021,South Somerset 020,E02006094,2449,1821,1178,643,5,5,326,67,259,296,238,58,1
2021,South Somerset 021,E02006095,3883,2699,1671,1028,39,39,493,80,413,651,584,67,1
2021,South Somerset 022,E02006096,3221,2113,1225,888,61,61,556,98,458,487,424,63,4
2021,South Somerset 023,E02006097,3128,1749,1059,690,26,26,719,150,569,631,573,58,3
2021,South Somerset 024,E02006098,3274,2604,1804,800,20,20,239,42,197,410,312,98,1
2021,Somerset West and Taunton 006,E02006099,2957,2179,1200,979,14,14,299,163,136,462,399,63,3
2021,Somerset West and Taunton 007,E02006100,3321,2356,1305,1051,37,37,380,203,177,541,466,75,7
2021,Somerset West and Taunton 013,E02006101,2527,1810,1196,614,19,19,293,227,66,403,330,73,2
2021,Somerset West and Taunton 010,E02006102,3045,1508,784,724,11,11,1203,1027,176,304,268,36,19
2021,Somerset West and Taunton 009,E02006103,3459,2732,1719,1013,64,64,272,162,110,386,314,72,5
2021,Somerset West and Taunton 008,E02006104,4519,3053,1390,1663,122,122,517,328,189,822,758,64,5
2021,Somerset West and Taunton 011,E02006105,5424,2848,1504,1344,37,37,505,170,335,2030,1856,174,4
2021,Somerset West and Taunton 012,E02006106,4084,2710,1264,1446,68,68,683,425,258,618,515,103,5
2021,Somerset West and Taunton 014,E02006107,3608,1541,749,792,20,20,1627,1203,424,412,354,58,8
2021,Somerset West and Taunton 015,E02006108,4462,2399,1629,770,47,47,667,286,381,1344,1204,140,5
2021,Somerset West and Taunton 016,E02006109,3421,2768,1741,1027,8,8,117,73,44,527,441,86,1
2021,Somerset West and Taunton 018,E02006110,4620,2666,1303,1363,68,68,1066,675,391,803,722,81,17
2021,Somerset West and Taunton 017,E02006111,4633,3617,2346,1271,44,44,349,200,149,622,512,110,1
2021,Somerset West and Taunton 019,E02006112,3459,2751,1656,1095,14,14,204,134,70,488,385,103,2
2021,Somerset West and Taunton 001,E02006113,3503,2258,1589,669,17,17,331,59,272,897,785,112,0
2021,Somerset West and Taunton 002,E02006114,3016,1917,1519,398,13,13,595,65,530,487,404,83,4
2021,Somerset West and Taunton 003,E02006115,3592,2238,1601,637,27,27,792,85,707,534,456,78,1
2021,Somerset West and Taunton 004,E02006116,3640,2612,1888,724,11,11,302,35,267,715,592,123,0
2021,Somerset West and Taunton 005,E02006117,2703,1798,1348,450,12,12,418,48,370,475,357,118,0
2021,Cannock Chase 001,E02006118,3164,2678,1586,1092,14,14,74,42,32,395,337,58,3
2021,Cannock Chase 002,E02006119,3591,2016,1025,991,11,11,761,505,256,798,726,72,5
2021,Cannock Chase 003,E02006120,3921,2695,1390,1305,25,25,501,333,168,693,624,69,7
2021,Cannock Chase 004,E02006121,2535,1716,827,889,21,21,465,372,93,320,278,42,13
2021,Cannock Chase 005,E02006122,3538,2420,1048,1372,29,29,495,337,158,590,534,56,4
2021,Cannock Chase 006,E02006123,2668,1941,937,1004,4,4,360,302,58,359,321,38,4
2021,Cannock Chase 007,E02006124,3110,1649,826,823,61,61,1041,727,314,334,287,47,25
2021,Cannock Chase 008,E02006125,3316,1943,1044,899,18,18,767,610,157,578,520,58,10
2021,Cannock Chase 009,E02006126,3559,2656,1264,1392,22,22,314,263,51,560,505,55,7
2021,Cannock Chase 010,E02006127,2778,2193,906,1287,16,16,152,19,133,417,387,30,0
2021,Cannock Chase 011,E02006128,3913,2747,1702,1045,10,10,525,262,263,621,539,82,10
2021,Cannock Chase 012,E02006129,3844,1957,955,1002,40,40,1034,707,327,794,713,81,19
2021,Cannock Chase 013,E02006130,3523,2547,1206,1341,25,25,542,415,127,404,338,66,5
2021,East Staffordshire 001,E02006131,3196,2482,1501,981,19,19,275,79,196,418,326,92,2
2021,East Staffordshire 002,E02006132,2926,2107,1103,1004,70,70,451,168,283,296,255,41,2
2021,East Staffordshire 003,E02006133,3076,2123,1143,980,14,14,333,102,231,605,535,70,1
2021,East Staffordshire 004,E02006134,4515,3598,2035,1563,31,31,404,151,253,480,410,70,2
2021,East Staffordshire 005,E02006135,3413,2863,1715,1148,5,5,147,52,95,396,336,60,2
2021,East Staffordshire 006,E02006136,3381,2776,1764,1012,17,17,181,46,135,407,321,86,0
2021,East Staffordshire 007,E02006137,3786,2157,1135,1022,29,29,768,292,476,829,743,86,3
2021,East Staffordshire 008,E02006138,3077,1604,615,989,21,21,547,190,357,903,820,83,2
2021,East Staffordshire 009,E02006139,3325,1497,782,715,27,27,546,180,366,1248,1131,117,7
2021,East Staffordshire 010,E02006140,3454,2164,1249,915,11,11,758,284,474,517,456,61,4
2021,East Staffordshire 011,E02006141,4892,2003,923,1080,47,47,671,166,505,2170,2001,169,1
2021,East Staffordshire 012,E02006142,2252,1972,1117,855,7,7,38,10,28,235,200,35,0
2021,East Staffordshire 013,E02006143,3776,2938,1303,1635,13,13,240,97,143,585,517,68,0
2021,East Staffordshire 014,E02006144,3689,1904,1047,857,24,24,1148,421,727,606,534,72,7
2021,East Staffordshire 015,E02006145,2534,2086,1261,825,20,20,126,38,88,302,261,41,0
2021,Lichfield 001,E02006146,3774,2818,1461,1357,48,48,388,49,339,519,440,79,1
2021,Lichfield 002,E02006147,3464,2770,1482,1288,42,42,319,35,284,333,281,52,0
2021,Lichfield 003,E02006148,3011,2555,1560,995,2,2,169,16,153,285,235,50,0
2021,Lichfield 004,E02006149,5053,2425,1397,1028,51,51,1714,234,1480,863,758,105,0
2021,Lichfield 005,E02006150,5118,4088,2529,1559,66,66,407,42,365,557,481,76,0
2021,Lichfield 006,E02006151,4250,3022,1572,1450,41,41,653,104,549,534,458,76,0
2021,Lichfield 007,E02006152,4549,3354,1822,1532,41,41,495,63,432,659,587,72,0
2021,Lichfield 008,E02006153,3764,2778,1356,1422,107,107,350,30,320,526,369,157,3
2021,Lichfield 009,E02006154,4231,3633,2317,1316,21,21,180,24,156,395,329,66,2
2021,Lichfield 010,E02006155,2423,1365,693,672,7,7,627,72,555,424,380,44,0
2021,Lichfield 011,E02006156,3168,2723,1651,1072,4,4,178,23,155,263,216,47,0
2021,Lichfield 012,E02006157,2830,1900,1063,837,14,14,457,48,409,457,391,66,2
2021,Newcastle-under-Lyme 001,E02006158,3528,3114,1821,1293,8,8,118,28,90,288,239,49,0
2021,Newcastle-under-Lyme 002,E02006159,2492,1576,912,664,9,9,447,132,315,458,413,45,2
2021,Newcastle-under-Lyme 003,E02006160,3818,2500,1356,1144,31,31,858,284,574,427,356,71,2
2021,Newcastle-under-Lyme 004,E02006161,2779,2374,1367,1007,9,9,141,37,104,254,196,58,1
2021,Newcastle-under-Lyme 005,E02006162,3697,2757,1602,1155,20,20,498,154,344,419,341,78,3
2021,Newcastle-under-Lyme 006,E02006163,3200,2099,1081,1018,16,16,763,276,487,317,257,60,5
2021,Newcastle-under-Lyme 007,E02006164,3100,1492,773,719,4,4,981,341,640,617,543,74,6
2021,Newcastle-under-Lyme 008,E02006165,3524,2271,1115,1156,24,24,504,101,403,725,645,80,0
2021,Newcastle-under-Lyme 009,E02006166,3145,2525,1417,1108,8,8,125,27,98,486,416,70,1
2021,Newcastle-under-Lyme 010,E02006167,4309,1853,876,977,79,79,1677,553,1124,691,609,82,9
2021,Newcastle-under-Lyme 011,E02006168,3995,1638,995,643,15,15,1161,284,877,1175,1059,116,6
2021,Newcastle-under-Lyme 012,E02006169,2426,1535,812,723,32,32,447,152,295,410,325,85,2
2021,Newcastle-under-Lyme 013,E02006170,2326,1722,1059,663,16,16,277,65,212,307,249,58,4
2021,Newcastle-under-Lyme 014,E02006171,3982,2733,1587,1146,22,22,736,233,503,488,424,64,3
2021,Newcastle-under-Lyme 015,E02006172,4110,3468,2126,1342,39,39,255,67,188,348,291,57,0
2021,Newcastle-under-Lyme 016,E02006173,2996,2500,1541,959,17,17,154,40,114,325,250,75,0
2021,South Staffordshire 001,E02006174,4696,3483,2025,1458,109,109,559,73,486,545,460,85,0
2021,South Staffordshire 002,E02006175,2784,1899,933,966,54,54,535,50,485,296,247,49,0
2021,South Staffordshire 003,E02006176,3186,2363,1542,821,21,21,352,26,326,450,378,72,0
2021,South Staffordshire 004,E02006177,4203,3331,1923,1408,30,30,486,50,436,356,285,71,0
2021,South Staffordshire 005,E02006178,3227,2282,1319,963,7,7,609,68,541,328,276,52,1
2021,South Staffordshire 006,E02006179,2856,2335,1420,915,16,16,228,26,202,277,229,48,0
2021,South Staffordshire 007,E02006180,2774,1856,1055,801,29,29,671,61,610,218,182,36,0
2021,South Staffordshire 008,E02006181,2551,1555,933,622,15,15,723,61,662,254,203,51,4
2021,South Staffordshire 009,E02006182,2916,2500,1450,1050,34,34,164,13,151,218,185,33,0
2021,South Staffordshire 012,E02006185,3188,1972,1184,788,24,24,797,80,717,390,346,44,5
2021,South Staffordshire 013,E02006186,5282,4302,2609,1693,14,14,423,37,386,543,456,87,0
2021,South Staffordshire 014,E02006187,3124,2527,1635,892,8,8,286,25,261,302,253,49,1
2021,Stafford 001,E02006188,2574,2107,1303,804,12,12,232,64,168,223,176,47,0
2021,Stafford 002,E02006189,3111,2425,1510,915,6,6,314,96,218,362,291,71,4
2021,Stafford 003,E02006190,5102,3240,1728,1512,41,41,850,184,666,970,861,109,1
2021,Stafford 004,E02006191,3474,2864,1725,1139,23,23,167,38,129,420,356,64,0
2021,Stafford 005,E02006192,3949,3014,1675,1339,62,62,384,89,295,488,406,82,1
2021,Stafford 006,E02006193,3243,2734,1387,1347,23,23,133,51,82,352,302,50,1
2021,Stafford 007,E02006194,3624,2195,1128,1067,55,55,894,252,642,477,417,60,3
2021,Stafford 008,E02006195,3865,3164,1928,1236,30,30,300,54,246,370,313,57,1
2021,Stafford 009,E02006196,2920,1362,555,807,18,18,751,185,566,788,596,192,1
2021,Stafford 010,E02006197,4884,1834,850,984,36,36,930,155,775,2082,1745,337,2
2021,Stafford 011,E02006198,3681,2982,1540,1442,40,40,174,27,147,485,395,90,0
2021,Stafford 012,E02006199,3581,2891,1681,1210,32,32,211,49,162,447,381,66,0
2021,Stafford 013,E02006200,3466,1642,844,798,34,34,1340,371,969,442,382,60,8
2021,Stafford 014,E02006201,5096,4521,2723,1798,25,25,91,16,75,459,375,84,0
2021,Stafford 015,E02006202,4053,3122,1916,1206,35,35,383,120,263,510,389,121,3
2021,Stafford 016,E02006203,3418,1935,981,954,28,28,991,289,702,460,401,59,4
2021,Staffordshire Moorlands 001,E02006204,3209,2116,1341,775,39,39,628,216,412,418,346,72,8
2021,Staffordshire Moorlands 002,E02006205,3190,2874,1881,993,14,14,60,7,53,242,183,59,0
2021,Staffordshire Moorlands 003,E02006206,3403,2036,995,1041,6,6,773,283,490,586,533,53,2
2021,Staffordshire Moorlands 004,E02006207,2851,2487,1664,823,12,12,103,23,80,248,197,51,1
2021,Staffordshire Moorlands 005,E02006208,3989,2377,1349,1028,18,18,550,103,447,1041,930,111,3
2021,Staffordshire Moorlands 006,E02006209,4617,3891,2364,1527,13,13,240,51,189,471,393,78,2
2021,Staffordshire Moorlands 007,E02006210,2266,1835,1261,574,9,9,119,29,90,301,236,65,2
2021,Staffordshire Moorlands 008,E02006211,2745,2422,1524,898,4,4,71,24,47,248,198,50,0
2021,Staffordshire Moorlands 009,E02006212,3333,2971,1877,1094,6,6,85,28,57,268,202,66,3
2021,Staffordshire Moorlands 010,E02006213,2865,2183,1312,871,5,5,318,91,227,357,296,61,2
2021,Staffordshire Moorlands 011,E02006214,2884,1932,1172,760,11,11,426,115,311,515,452,63,0
2021,Staffordshire Moorlands 012,E02006215,3419,2900,1801,1099,13,13,160,64,96,346,269,77,0
2021,Staffordshire Moorlands 013,E02006216,3589,3121,1864,1257,10,10,123,36,87,334,266,68,1
2021,Tamworth 001,E02006217,4186,3252,1779,1473,51,51,488,337,151,389,333,56,6
2021,Tamworth 002,E02006218,4109,1874,983,891,36,36,1263,804,459,923,848,75,13
2021,Tamworth 003,E02006219,3388,2419,1135,1284,18,18,607,421,186,338,294,44,6
2021,Tamworth 004,E02006220,3183,2288,1288,1000,18,18,479,426,53,392,350,42,6
2021,Tamworth 005,E02006221,2509,1782,870,912,25,25,185,132,53,513,479,34,4
2021,Tamworth 006,E02006222,2794,1780,841,939,7,7,555,457,98,447,404,43,5
2021,Tamworth 007,E02006223,2655,1013,398,615,12,12,1260,848,412,365,324,41,5
2021,Tamworth 008,E02006224,3008,2361,1056,1305,3,3,320,189,131,324,304,20,0
2021,Tamworth 009,E02006225,3039,2519,1350,1169,8,8,175,105,70,336,296,40,1
2021,Tamworth 010,E02006226,4022,2748,1266,1482,55,55,593,382,211,616,560,56,10
2021,Babergh 001,E02006227,2994,2087,1399,688,25,25,492,317,175,385,296,89,5
2021,Babergh 002,E02006228,2644,2000,1211,789,2,2,258,154,104,382,312,70,2
2021,Babergh 003,E02006229,2805,2000,1325,675,25,25,386,240,146,387,329,58,7
2021,Babergh 004,E02006230,4666,3117,1988,1129,34,34,705,468,237,791,589,202,19
2021,Babergh 005,E02006231,3768,2747,1423,1324,11,11,412,145,267,597,511,86,1
2021,Babergh 006,E02006232,2607,2023,1251,772,5,5,270,156,114,306,246,60,3
2021,Babergh 007,E02006233,5466,3125,1952,1173,58,58,1045,740,305,1228,1121,107,10
2021,Babergh 008,E02006234,4050,2680,1437,1243,53,53,759,493,266,555,494,61,3
2021,Babergh 009,E02006235,3541,2765,1727,1038,15,15,336,211,125,422,325,97,3
2021,Babergh 010,E02006236,4420,3607,2236,1371,41,41,328,196,132,442,347,95,2
2021,Babergh 011,E02006237,3239,2407,1511,896,20,20,341,249,92,465,341,124,6
2021,West Suffolk 002,E02006238,4501,2727,1660,1067,44,44,667,189,478,1059,938,121,4
2021,West Suffolk 001,E02006239,3321,1678,899,779,10,10,325,68,257,1305,825,480,3
2021,West Suffolk 003,E02006240,4226,2321,1243,1078,144,144,422,88,334,1339,1096,243,0
2021,West Suffolk 004,E02006241,4049,2127,1204,923,33,33,816,228,588,1067,984,83,6
2021,West Suffolk 007,E02006242,4543,2625,1071,1554,140,140,563,127,436,1215,1091,124,0
2021,West Suffolk 008,E02006243,4422,2180,1027,1153,96,96,940,236,704,1203,1039,164,3
2021,Ipswich 001,E02006245,3264,1979,1119,860,9,9,991,864,127,274,229,45,11
2021,Ipswich 002,E02006246,3061,2556,1414,1142,4,4,200,131,69,301,243,58,0
2021,Ipswich 003,E02006247,3855,2123,947,1176,40,40,959,602,357,722,658,64,11
2021,Ipswich 004,E02006248,3357,2322,1174,1148,4,4,601,440,161,421,366,55,9
2021,Ipswich 005,E02006249,3663,2389,1356,1033,14,14,296,148,148,960,888,72,4
2021,Ipswich 006,E02006250,4515,1746,723,1023,28,28,869,454,415,1869,1757,112,3
2021,Ipswich 007,E02006251,5199,1990,879,1111,47,47,820,270,550,2332,2219,113,10
2021,Ipswich 008,E02006252,4165,2590,1164,1426,39,39,449,122,327,1087,1010,77,0
2021,Ipswich 009,E02006253,3186,2547,1578,969,8,8,158,78,80,473,437,36,0
2021,Ipswich 010,E02006254,4010,1615,753,862,30,30,1287,895,392,1064,991,73,14
2021,Ipswich 011,E02006255,3533,1982,1056,926,23,23,246,86,160,1282,1197,85,0
2021,Ipswich 012,E02006256,4298,1755,835,920,67,67,1271,640,631,1193,1121,72,12
2021,Ipswich 013,E02006257,2959,1735,986,749,7,7,803,699,104,396,348,48,18
2021,Ipswich 014,E02006258,3749,2020,874,1146,16,16,1132,811,321,572,498,74,9
2021,Ipswich 015,E02006259,3170,1646,992,654,9,9,1210,480,730,294,251,43,11
2021,Ipswich 016,E02006260,3524,1996,960,1036,9,9,1073,894,179,429,371,58,17
2021,Mid Suffolk 001,E02006261,3438,2594,1711,883,17,17,394,291,103,427,331,96,6
2021,Mid Suffolk 002,E02006262,3850,2965,1852,1113,32,32,362,240,122,488,388,100,3
2021,Mid Suffolk 003,E02006263,3288,2469,1667,802,10,10,371,288,83,436,331,105,2
2021,Mid Suffolk 004,E02006264,3759,2978,1667,1311,42,42,240,142,98,496,386,110,3
2021,Mid Suffolk 005,E02006265,3265,2478,1527,951,49,49,421,260,161,316,231,85,1
2021,Mid Suffolk 006,E02006266,4155,3004,1892,1112,91,91,713,384,329,340,276,64,7
2021,Mid Suffolk 007,E02006267,3502,2714,1656,1058,14,14,267,166,101,502,396,106,5
2021,Mid Suffolk 008,E02006268,2775,1581,983,598,30,30,868,584,284,290,237,53,6
2021,Mid Suffolk 009,E02006269,3228,2555,1378,1177,17,17,231,114,117,425,371,54,0
2021,Mid Suffolk 010,E02006270,5580,3815,1721,2094,60,60,432,222,210,1270,1146,124,3
2021,Mid Suffolk 011,E02006271,4169,2997,1586,1411,54,54,394,230,164,718,464,254,6
2021,Mid Suffolk 012,E02006272,3331,2606,1509,1097,28,28,318,222,96,373,317,56,6
2021,West Suffolk 005,E02006273,3051,2310,1480,830,23,23,330,127,203,386,270,116,2
2021,West Suffolk 006,E02006274,2654,1645,1011,634,7,7,336,100,236,663,436,227,3
2021,West Suffolk 009,E02006275,2926,1396,701,695,17,17,1176,505,671,329,281,48,8
2021,West Suffolk 016,E02006276,3529,2519,1456,1063,87,87,426,119,307,495,426,69,2
2021,West Suffolk 012,E02006277,3272,2149,1063,1086,62,62,204,23,181,857,807,50,0
2021,West Suffolk 011,E02006278,4525,2069,1239,830,63,63,808,193,615,1583,1482,101,2
2021,West Suffolk 014,E02006279,4068,2704,1747,957,26,26,743,231,512,595,514,81,0
2021,West Suffolk 010,E02006280,4030,3071,1862,1209,31,31,454,137,317,473,380,93,1
2021,West Suffolk 013,E02006281,4037,2612,1791,821,24,24,629,146,483,772,687,85,0
2021,West Suffolk 017,E02006282,3006,2107,1366,741,18,18,459,164,295,417,343,74,5
2021,West Suffolk 018,E02006283,2913,2224,1173,1051,24,24,226,65,161,437,343,94,2
2021,West Suffolk 019,E02006284,3283,2034,976,1058,32,32,752,278,474,462,399,63,3
2021,West Suffolk 021,E02006285,3025,1882,792,1090,15,15,602,245,357,524,484,40,2
2021,West Suffolk 020,E02006286,4573,2626,1281,1345,25,25,1007,367,640,914,840,74,1
2021,East Suffolk 016,E02006287,2903,2196,1642,554,12,12,254,37,217,438,329,109,3
2021,East Suffolk 017,E02006288,4301,3063,1958,1105,22,22,512,48,464,704,570,134,0
2021,East Suffolk 018,E02006289,4449,2927,1997,930,29,29,854,136,718,639,544,95,0
2021,East Suffolk 019,E02006290,3943,2476,1800,676,11,11,709,103,606,746,633,113,1
2021,East Suffolk 020,E02006291,3594,2544,1707,837,18,18,574,69,505,457,383,74,1
2021,East Suffolk 021,E02006292,2836,2267,1425,842,15,15,279,35,244,275,219,56,0
2021,East Suffolk 023,E02006293,4328,2983,1761,1222,17,17,391,39,352,935,687,248,2
2021,East Suffolk 022,E02006294,3825,2592,1838,754,12,12,571,73,498,648,553,95,2
2021,East Suffolk 024,E02006295,3990,3127,1920,1207,10,10,307,35,272,545,480,65,1
2021,East Suffolk 025,E02006296,5464,4212,2436,1776,23,23,268,45,223,959,873,86,2
2021,East Suffolk 026,E02006297,3350,2943,1848,1095,14,14,58,14,44,334,277,57,1
2021,East Suffolk 027,E02006298,4037,3077,1756,1321,22,22,379,58,321,559,500,59,0
2021,East Suffolk 028,E02006299,3883,3271,2376,895,5,5,201,42,159,406,338,68,0
2021,East Suffolk 029,E02006300,3783,1874,1033,841,8,8,1198,195,1003,700,627,73,3
2021,East Suffolk 030,E02006301,3016,1696,1110,586,9,9,349,71,278,961,883,78,1
2021,East Suffolk 001,E02006302,3004,2427,1659,768,15,15,153,115,38,407,354,53,2
2021,East Suffolk 002,E02006303,3328,1633,845,788,9,9,1222,918,304,456,400,56,8
2021,East Suffolk 003,E02006304,3672,2807,1793,1014,14,14,466,96,370,382,339,43,3
2021,East Suffolk 004,E02006305,4365,1945,1066,879,25,25,520,136,384,1870,1737,133,5
2021,East Suffolk 005,E02006306,3322,2316,1419,897,12,12,448,304,144,544,481,63,2
2021,East Suffolk 007,E02006307,3232,2824,1891,933,7,7,53,35,18,347,297,50,1
2021,East Suffolk 006,E02006308,3848,1437,850,587,7,7,807,358,449,1597,1523,74,0
2021,East Suffolk 009,E02006309,3019,1840,1170,670,3,3,792,401,391,378,319,59,6
2021,East Suffolk 008,E02006310,3442,2495,1362,1133,11,11,295,88,207,639,570,69,2
2021,East Suffolk 010,E02006311,3908,2357,1613,744,32,32,696,373,323,814,720,94,9
2021,East Suffolk 011,E02006312,3742,2912,1822,1090,7,7,339,158,181,482,422,60,2
2021,East Suffolk 012,E02006313,4627,3491,2281,1210,19,19,402,174,228,715,597,118,0
2021,East Suffolk 013,E02006314,3329,2242,1482,760,19,19,444,300,144,623,523,100,1
2021,East Suffolk 014,E02006315,2811,1968,1462,506,29,29,421,282,139,391,322,69,2
2021,East Suffolk 015,E02006316,3396,2336,1691,645,11,11,518,356,162,529,453,76,2
2021,Elmbridge 001,E02006317,2538,1993,1005,988,32,32,199,30,169,314,288,26,0
2021,Elmbridge 002,E02006318,2931,2209,1080,1129,56,56,81,9,72,583,529,54,2
2021,Elmbridge 003,E02006319,2908,1889,826,1063,27,27,589,111,478,399,364,35,4
2021,Elmbridge 004,E02006320,3067,1780,730,1050,83,83,697,158,539,504,455,49,3
2021,Elmbridge 005,E02006321,2490,1947,829,1118,10,10,138,11,127,390,363,27,5
2021,Elmbridge 006,E02006322,2525,1932,849,1083,7,7,273,42,231,311,278,33,2
2021,Elmbridge 007,E02006323,3388,2158,1098,1060,69,69,267,45,222,893,838,55,1
2021,Elmbridge 008,E02006324,2928,2101,900,1201,25,25,389,80,309,412,379,33,1
2021,Elmbridge 009,E02006325,3332,2846,1272,1574,13,13,102,8,94,370,331,39,1
2021,Elmbridge 010,E02006326,3119,2012,879,1133,91,91,343,35,308,672,623,49,1
2021,Elmbridge 011,E02006327,2801,2119,1091,1028,3,3,137,20,117,539,504,35,3
2021,Elmbridge 012,E02006328,4184,2623,1194,1429,30,30,398,58,340,1133,1048,85,0
2021,Elmbridge 013,E02006329,2796,1999,1024,975,23,23,274,45,229,500,439,61,0
2021,Elmbridge 014,E02006330,4021,2741,1247,1494,42,42,709,111,598,527,470,57,2
2021,Elmbridge 015,E02006331,2806,2251,1162,1089,17,17,243,39,204,294,250,44,1
2021,Elmbridge 016,E02006332,2624,1834,879,955,23,23,104,13,91,663,604,59,0
2021,Elmbridge 017,E02006333,3901,2577,1346,1231,10,10,528,110,418,785,706,79,1
2021,Elmbridge 018,E02006334,3232,2627,1396,1231,28,28,140,18,122,437,361,76,0
2021,Epsom and Ewell 001,E02006335,3123,2505,1352,1153,5,5,178,15,163,434,381,53,1
2021,Epsom and Ewell 002,E02006336,2736,1922,840,1082,36,36,471,34,437,307,277,30,0
2021,Epsom and Ewell 003,E02006337,3301,2913,1493,1420,6,6,57,6,51,325,289,36,0
2021,Epsom and Ewell 004,E02006338,2576,2184,1096,1088,29,29,112,10,102,251,224,27,0
2021,Epsom and Ewell 005,E02006339,4017,2596,1013,1583,153,153,633,39,594,634,574,60,1
2021,Epsom and Ewell 007,E02006341,4110,2703,1339,1364,55,55,497,30,467,855,789,66,0
2021,Epsom and Ewell 008,E02006342,3700,2014,1081,933,37,37,388,34,354,1260,1188,72,1
2021,Epsom and Ewell 009,E02006343,3314,2767,1334,1433,7,7,167,13,154,372,307,65,1
2021,Guildford 001,E02006344,3472,2643,1478,1165,31,31,391,251,140,405,321,84,2
2021,Guildford 002,E02006345,2449,1681,977,704,20,20,216,130,86,532,218,314,0
2021,Guildford 003,E02006346,3901,3307,1872,1435,26,26,221,151,70,347,294,53,0
2021,Guildford 004,E02006347,3076,2336,1167,1169,19,19,190,113,77,530,454,76,1
2021,Guildford 005,E02006348,3454,2586,1460,1126,31,31,373,216,157,463,381,82,1
2021,Guildford 006,E02006349,3125,2025,894,1131,99,99,324,177,147,676,616,60,1
2021,Guildford 007,E02006350,2452,1172,519,653,34,34,835,715,120,398,341,57,13
2021,Guildford 008,E02006351,3391,2275,1109,1166,28,28,445,316,129,639,581,58,4
2021,Guildford 009,E02006352,2290,1416,692,724,46,46,300,281,19,526,492,34,2
2021,Guildford 010,E02006353,2602,1711,825,886,13,13,626,307,319,250,214,36,2
2021,Guildford 011,E02006354,3816,2972,1614,1358,42,42,118,48,70,684,632,52,0
2021,Guildford 012,E02006355,2364,791,438,353,24,24,935,850,85,611,563,48,3
2021,Guildford 013,E02006356,5359,2288,1116,1172,104,104,634,247,387,2328,2190,138,5
2021,Guildford 014,E02006357,3022,2373,1086,1287,62,62,325,222,103,259,237,22,3
2021,Guildford 015,E02006358,2754,1407,681,726,80,80,391,288,103,872,821,51,4
2021,Guildford 016,E02006359,2619,1851,1020,831,9,9,181,122,59,576,532,44,2
2021,Guildford 017,E02006360,3290,2425,1264,1161,49,49,358,300,58,456,360,96,2
2021,Guildford 018,E02006361,2327,1726,1056,670,14,14,199,125,74,383,309,74,5
2021,Mole Valley 001,E02006362,2741,2206,1231,975,11,11,271,25,246,253,212,41,0
2021,Mole Valley 002,E02006363,2379,1935,1046,889,11,11,156,20,136,277,246,31,0
2021,Mole Valley 003,E02006364,3453,1755,728,1027,100,100,762,128,634,834,758,76,2
2021,Mole Valley 004,E02006365,2749,2048,1172,876,27,27,196,20,176,478,413,65,0
2021,Mole Valley 005,E02006366,3179,2790,1536,1254,12,12,149,19,130,228,185,43,0
2021,Mole Valley 006,E02006367,2587,1958,1211,747,32,32,316,46,270,281,236,45,0
2021,Mole Valley 007,E02006368,2420,1914,1163,751,4,4,265,47,218,237,205,32,0
2021,Mole Valley 008,E02006369,2833,2278,1468,810,17,17,218,19,199,319,259,60,1
2021,Mole Valley 009,E02006370,2838,2063,1086,977,12,12,204,24,180,558,472,86,1
2021,Mole Valley 010,E02006371,3198,2122,1183,939,39,39,408,40,368,628,560,68,1
2021,Mole Valley 011,E02006372,2711,1668,817,851,61,61,705,100,605,277,241,36,0
2021,Mole Valley 012,E02006373,3092,2212,1227,985,27,27,349,46,303,504,429,75,0
2021,Mole Valley 013,E02006374,2957,2241,1268,973,27,27,327,39,288,362,289,73,0
2021,Reigate and Banstead 001,E02006375,2564,2210,1085,1125,7,7,145,15,130,202,181,21,0
2021,Reigate and Banstead 002,E02006376,3349,2664,1543,1121,26,26,232,48,184,427,383,44,0
2021,Reigate and Banstead 003,E02006377,2374,2060,1111,949,5,5,123,21,102,186,164,22,0
2021,Reigate and Banstead 004,E02006378,3365,2756,1282,1474,54,54,240,31,209,314,265,49,1
2021,Reigate and Banstead 005,E02006379,2812,1624,593,1031,122,122,825,110,715,238,205,33,3
2021,Reigate and Banstead 006,E02006380,2901,2498,1431,1067,4,4,98,17,81,301,264,37,0
2021,Reigate and Banstead 007,E02006381,2888,2431,1264,1167,13,13,125,20,105,319,271,48,0
2021,Reigate and Banstead 008,E02006382,2668,1667,652,1015,53,53,668,148,520,280,250,30,0
2021,Reigate and Banstead 009,E02006383,4019,3023,1491,1532,19,19,137,11,126,840,749,91,0
2021,Reigate and Banstead 010,E02006384,4500,2568,1273,1295,100,100,787,154,633,1044,967,77,1
2021,Reigate and Banstead 011,E02006385,4750,2739,1029,1710,120,120,415,33,382,1469,1384,85,7
2021,Reigate and Banstead 012,E02006386,3333,2320,1068,1252,30,30,333,26,307,650,585,65,0
2021,Reigate and Banstead 013,E02006387,2651,1769,831,938,33,33,600,86,514,249,220,29,0
2021,Reigate and Banstead 014,E02006388,3798,2574,1092,1482,31,31,519,75,444,674,613,61,0
2021,Reigate and Banstead 015,E02006389,2843,2072,1027,1045,12,12,456,102,354,303,246,57,0
2021,Reigate and Banstead 016,E02006390,4077,2943,1236,1707,151,151,631,114,517,350,304,46,2
2021,Reigate and Banstead 017,E02006391,3005,2307,998,1309,80,80,138,8,130,480,438,42,0
2021,Reigate and Banstead 018,E02006392,3950,2346,1193,1153,107,107,431,60,371,1064,994,70,2
2021,Runnymede 001,E02006393,2846,1427,739,688,25,25,337,206,131,1051,1000,51,6
2021,Runnymede 002,E02006394,3492,1735,901,834,43,43,678,405,273,1032,939,93,4
2021,Runnymede 003,E02006395,3885,2526,1094,1432,29,29,704,528,176,618,557,61,8
2021,Runnymede 004,E02006396,2446,1892,1123,769,20,20,199,126,73,334,278,56,1
2021,Runnymede 005,E02006397,2486,1835,975,860,39,39,107,65,42,505,423,82,0
2021,Runnymede 006,E02006398,3791,2302,938,1364,47,47,670,432,238,766,694,72,6
2021,Runnymede 007,E02006399,5116,3676,1711,1965,85,85,522,279,243,827,738,89,6
2021,Runnymede 008,E02006400,2375,1683,926,757,12,12,262,55,207,418,325,93,0
2021,Runnymede 009,E02006401,4483,2872,1408,1464,187,187,737,436,301,684,606,78,3
2021,Runnymede 010,E02006402,3916,3193,1616,1577,20,20,283,239,44,416,348,68,4
2021,Spelthorne 001,E02006403,2709,1360,585,775,73,73,698,105,593,577,532,45,1
2021,Spelthorne 002,E02006404,2766,1524,579,945,78,78,678,109,569,484,434,50,2
2021,Spelthorne 003,E02006405,4439,3231,1540,1691,35,35,247,58,189,925,846,79,1
2021,Spelthorne 004,E02006406,4010,2088,949,1139,36,36,464,52,412,1420,1337,83,2
2021,Spelthorne 005,E02006407,3678,2760,1382,1378,19,19,364,60,304,535,475,60,0
2021,Spelthorne 006,E02006408,3707,2574,1195,1379,65,65,322,32,290,744,674,70,2
2021,Spelthorne 007,E02006409,2706,1742,820,922,32,32,653,94,559,277,243,34,2
2021,Spelthorne 008,E02006410,3255,1856,785,1071,63,63,735,102,633,596,551,45,5
2021,Spelthorne 009,E02006411,3060,2468,1316,1152,16,16,148,15,133,428,398,30,0
2021,Spelthorne 010,E02006412,3163,2386,1241,1145,50,50,239,45,194,486,425,61,2
2021,Spelthorne 011,E02006413,2629,1993,1065,928,19,19,332,44,288,284,243,41,1
2021,Spelthorne 012,E02006414,2538,1979,1015,964,27,27,300,34,266,229,192,37,3
2021,Spelthorne 013,E02006415,3143,2503,1504,999,20,20,115,20,95,504,434,70,1
2021,Surrey Heath 001,E02006416,3553,2808,1514,1294,21,21,281,45,236,442,361,81,1
2021,Surrey Heath 002,E02006417,2584,1844,881,963,28,28,314,40,274,398,342,56,0
2021,Surrey Heath 003,E02006418,2794,2342,1291,1051,7,7,121,18,103,324,283,41,0
2021,Surrey Heath 004,E02006419,3246,1736,774,962,35,35,872,136,736,600,461,139,3
2021,Surrey Heath 005,E02006420,3088,2445,1289,1156,6,6,45,9,36,592,506,86,0
2021,Surrey Heath 006,E02006421,3576,2912,1319,1593,97,97,182,18,164,385,325,60,0
2021,Surrey Heath 007,E02006422,2455,2058,985,1073,19,19,72,12,60,306,282,24,0
2021,Surrey Heath 008,E02006423,4596,2679,1190,1489,80,80,757,103,654,1075,946,129,5
2021,Surrey Heath 009,E02006424,2429,2112,1066,1046,6,6,73,9,64,237,208,29,1
2021,Surrey Heath 010,E02006425,2524,1737,874,863,9,9,399,40,359,375,324,51,4
2021,Surrey Heath 011,E02006426,2252,1814,946,868,32,32,129,9,120,277,244,33,0
2021,Surrey Heath 012,E02006427,2903,2164,1026,1138,20,20,204,37,167,515,325,190,0
2021,Tandridge 002,E02006429,3617,2559,1174,1385,170,170,247,108,139,641,577,64,0
2021,Tandridge 003,E02006430,3756,2736,1148,1588,68,68,502,184,318,448,385,63,2
2021,Tandridge 004,E02006431,4569,3312,1578,1734,37,37,370,237,133,850,742,108,0
2021,Tandridge 005,E02006432,2303,1856,957,899,8,8,169,130,39,270,231,39,0
2021,Tandridge 006,E02006433,3871,3021,1661,1360,18,18,288,218,70,544,454,90,0
2021,Tandridge 007,E02006434,2558,1755,831,924,30,30,523,362,161,246,216,30,4
2021,Tandridge 008,E02006435,2496,1782,893,889,23,23,383,271,112,307,246,61,1
2021,Tandridge 009,E02006436,2538,1791,871,920,11,11,449,332,117,285,220,65,2
2021,Tandridge 010,E02006437,3413,2580,1399,1181,18,18,414,292,122,401,316,85,0
2021,Tandridge 011,E02006438,3336,2632,1424,1208,22,22,268,102,166,412,307,105,2
2021,Waverley 001,E02006439,2693,1988,1013,975,40,40,331,220,111,331,283,48,3
2021,Waverley 002,E02006440,2887,2256,1162,1094,8,8,288,101,187,335,298,37,0
2021,Waverley 003,E02006441,3732,2050,1183,867,72,72,671,463,208,933,855,78,6
2021,Waverley 004,E02006442,2398,1979,1068,911,5,5,88,72,16,325,286,39,1
2021,Waverley 005,E02006443,3269,1955,946,1009,47,47,759,616,143,501,440,61,7
2021,Waverley 006,E02006444,2789,2016,975,1041,29,29,425,360,65,317,284,33,2
2021,Waverley 007,E02006445,3501,2307,1084,1223,23,23,205,120,85,966,831,135,0
2021,Waverley 008,E02006446,2835,2161,1195,966,28,28,333,305,28,311,249,62,2
2021,Waverley 009,E02006447,2604,2021,1049,972,46,46,230,133,97,307,262,45,0
2021,Waverley 010,E02006448,2885,2195,1064,1131,20,20,338,261,77,331,298,33,1
2021,Waverley 011,E02006449,2996,2167,1225,942,53,53,423,351,72,350,296,54,3
2021,Waverley 012,E02006450,2763,2078,1076,1002,41,41,248,184,64,395,260,135,1
2021,Waverley 013,E02006451,4909,3517,2122,1395,134,134,660,417,243,597,466,131,1
2021,Waverley 015,E02006453,3434,2593,1551,1042,47,47,392,262,130,397,288,109,5
2021,Waverley 016,E02006454,2837,2037,1081,956,16,16,397,299,98,387,336,51,0
2021,Waverley 017,E02006455,2480,1678,798,880,11,11,336,295,41,452,402,50,3
2021,Woking 001,E02006456,3251,2390,1107,1283,25,25,373,296,77,460,408,52,3
2021,Woking 002,E02006457,3737,2989,1581,1408,5,5,140,59,81,600,497,103,3
2021,Woking 003,E02006458,3533,2730,1466,1264,5,5,261,108,153,536,485,51,1
2021,Woking 004,E02006459,3489,1622,680,942,35,35,799,618,181,1020,928,92,13
2021,Woking 005,E02006460,3932,2317,1143,1174,64,64,725,569,156,823,761,62,3
2021,Woking 006,E02006461,2768,1975,1081,894,10,10,143,48,95,640,570,70,0
2021,Woking 007,E02006462,3375,2328,1079,1249,59,59,340,204,136,647,589,58,1
2021,Woking 008,E02006463,5039,2414,1109,1305,32,32,424,186,238,2164,2058,106,5
2021,Woking 009,E02006464,2896,1978,941,1037,22,22,449,258,191,442,400,42,5
2021,Woking 010,E02006465,2489,1875,980,895,5,5,100,14,86,509,469,40,0
2021,Woking 011,E02006466,4153,2616,1009,1607,31,31,902,543,359,602,545,57,2
2021,Woking 012,E02006467,2777,2298,1076,1222,46,46,137,61,76,296,254,42,0
2021,North Warwickshire 001,E02006468,4524,3504,1854,1650,31,31,475,399,76,508,421,87,6
2021,North Warwickshire 002,E02006469,3603,2273,1188,1085,47,47,718,453,265,557,500,57,8
2021,North Warwickshire 003,E02006470,5240,3063,1789,1274,37,37,1114,730,384,1012,919,93,14
2021,North Warwickshire 004,E02006471,2924,2375,1397,978,27,27,220,135,85,300,234,66,2
2021,North Warwickshire 005,E02006472,4104,2840,1462,1378,68,68,602,364,238,588,508,80,6
2021,North Warwickshire 006,E02006473,4535,3378,1803,1575,32,32,398,243,155,723,639,84,4
2021,North Warwickshire 007,E02006474,2657,1981,1065,916,19,19,229,168,61,424,367,57,4
2021,Nuneaton and Bedworth 001,E02006475,4026,3223,1571,1652,69,69,394,238,156,336,282,54,4
2021,Nuneaton and Bedworth 002,E02006476,3978,2213,861,1352,37,37,972,620,352,750,679,71,6
2021,Nuneaton and Bedworth 003,E02006477,3473,2951,1483,1468,39,39,173,32,141,308,269,39,2
2021,Nuneaton and Bedworth 004,E02006478,3404,2708,1198,1510,40,40,214,89,125,441,396,45,1
2021,Nuneaton and Bedworth 005,E02006479,4119,1869,988,881,36,36,694,394,300,1516,1411,105,4
2021,Nuneaton and Bedworth 006,E02006480,3218,1919,974,945,10,10,715,554,161,571,490,81,3
2021,Nuneaton and Bedworth 007,E02006481,3037,1860,949,911,4,4,560,469,91,610,547,63,3
2021,Nuneaton and Bedworth 008,E02006482,3028,2147,1049,1098,38,38,237,78,159,603,547,56,3
2021,Nuneaton and Bedworth 009,E02006483,3197,1658,868,790,13,13,919,745,174,595,534,61,12
2021,Nuneaton and Bedworth 010,E02006484,3385,2062,995,1067,15,15,589,344,245,715,637,78,4
2021,Nuneaton and Bedworth 011,E02006485,2809,2583,1632,951,11,11,29,13,16,186,152,34,0
2021,Nuneaton and Bedworth 012,E02006486,3074,2265,1263,1002,45,45,342,237,105,419,366,53,3
2021,Nuneaton and Bedworth 013,E02006487,3052,1797,1008,789,19,19,841,562,279,388,336,52,7
2021,Nuneaton and Bedworth 014,E02006488,2804,2283,1521,762,4,4,242,180,62,273,222,51,2
2021,Nuneaton and Bedworth 015,E02006489,3371,2131,998,1133,27,27,453,357,96,753,682,71,7
2021,Nuneaton and Bedworth 016,E02006490,3116,2329,1194,1135,19,19,356,221,135,410,358,52,2
2021,Rugby 002,E02006493,4365,2748,1117,1631,67,67,681,321,360,866,799,67,3
2021,Rugby 003,E02006494,3282,1354,693,661,30,30,846,493,353,1034,956,78,18
2021,Rugby 004,E02006495,3327,2637,1486,1151,47,47,279,189,90,359,285,74,5
2021,Rugby 005,E02006496,2970,1451,665,786,24,24,208,123,85,1287,1234,53,0
2021,Rugby 006,E02006497,3456,1770,811,959,67,67,565,275,290,1047,964,83,7
2021,Rugby 007,E02006498,5344,3773,1604,2169,132,132,811,261,550,624,561,63,4
2021,Rugby 008,E02006499,2599,2183,1106,1077,27,27,59,16,43,330,308,22,0
2021,Rugby 009,E02006500,2446,1453,848,605,8,8,394,211,183,587,469,118,4
2021,Rugby 010,E02006501,4204,3077,1550,1527,44,44,578,443,135,497,424,73,8
2021,Rugby 011,E02006502,4719,3503,2124,1379,21,21,651,521,130,535,471,64,9
2021,Rugby 012,E02006503,4227,3218,1842,1376,88,88,506,292,214,415,329,86,0
2021,Stratford-on-Avon 001,E02006504,2380,1982,1196,786,19,19,142,15,127,237,181,56,0
2021,Stratford-on-Avon 002,E02006505,3235,2414,1568,846,33,33,391,47,344,397,335,62,0
2021,Stratford-on-Avon 003,E02006506,2644,1884,1079,805,29,29,361,46,315,370,306,64,0
2021,Stratford-on-Avon 004,E02006507,4803,3390,1694,1696,160,160,740,94,646,512,442,70,1
2021,Stratford-on-Avon 005,E02006508,4679,3514,1843,1671,85,85,547,70,477,531,444,87,2
2021,Stratford-on-Avon 006,E02006509,2806,1764,1111,653,16,16,554,78,476,469,401,68,3
2021,Stratford-on-Avon 007,E02006510,2967,2386,1563,823,37,37,209,24,185,335,288,47,0
2021,Stratford-on-Avon 008,E02006511,4548,3275,1781,1494,71,71,679,88,591,523,401,122,0
2021,Stratford-on-Avon 009,E02006512,5708,3152,1772,1380,113,113,1123,145,978,1318,1198,120,2
2021,Stratford-on-Avon 010,E02006513,3653,2757,1626,1131,74,74,322,24,298,500,440,60,0
2021,Stratford-on-Avon 011,E02006514,4234,2865,1871,994,42,42,465,39,426,862,771,91,0
2021,Stratford-on-Avon 012,E02006515,4780,3475,1881,1594,140,140,641,75,566,524,439,85,0
2021,Stratford-on-Avon 013,E02006516,4184,3036,1667,1369,35,35,489,60,429,622,452,170,2
2021,Stratford-on-Avon 014,E02006517,4142,2934,1501,1433,118,118,567,85,482,523,433,90,0
2021,Stratford-on-Avon 015,E02006518,4699,3295,2003,1292,87,87,678,68,610,639,523,116,0
2021,Warwick 001,E02006519,3675,2665,1614,1051,21,21,241,171,70,746,675,71,2
2021,Warwick 002,E02006520,3636,2881,1673,1208,51,51,196,119,77,507,451,56,1
2021,Warwick 003,E02006521,3208,2610,1621,989,10,10,273,205,68,310,272,38,5
2021,Warwick 004,E02006522,2455,1989,1138,851,10,10,159,98,61,297,236,61,0
2021,Warwick 005,E02006523,4331,3455,1927,1528,41,41,370,235,135,465,379,86,0
2021,Warwick 006,E02006524,2367,1293,671,622,6,6,822,745,77,238,213,25,8
2021,Warwick 007,E02006525,5904,3587,1953,1634,46,46,601,367,234,1666,1578,88,4
2021,Warwick 008,E02006526,3891,2645,1366,1279,72,72,657,393,264,515,457,58,2
2021,Warwick 009,E02006527,4189,2478,1354,1124,49,49,502,211,291,1160,1067,93,0
2021,Warwick 010,E02006528,4818,2415,1187,1228,93,93,800,341,459,1505,1419,86,5
2021,Warwick 011,E02006529,5599,3160,1410,1750,120,120,1097,836,261,1209,1106,103,13
2021,Warwick 012,E02006530,5576,3809,1790,2019,140,140,736,210,526,887,796,91,4
2021,Warwick 013,E02006531,4073,1437,648,789,85,85,1256,911,345,1291,1221,70,4
2021,Warwick 014,E02006532,4733,3523,1593,1930,118,118,620,196,424,471,402,69,1
2021,Warwick 015,E02006533,4171,3005,1466,1539,41,41,475,214,261,646,574,72,4
2021,Adur 001,E02006534,3612,2809,1510,1299,11,11,399,364,35,390,325,65,3
2021,Adur 002,E02006535,3019,2560,1475,1085,22,22,113,51,62,324,275,49,0
2021,Adur 003,E02006536,2911,2411,1293,1118,10,10,163,111,52,322,249,73,5
2021,Adur 004,E02006537,4366,2488,1237,1251,34,34,1188,853,335,654,567,87,2
2021,Adur 005,E02006538,4357,3033,1738,1295,78,78,317,169,148,926,842,84,3
2021,Adur 006,E02006539,3114,2277,1261,1016,10,10,458,386,72,363,292,71,6
2021,Adur 007,E02006540,2613,1796,1058,738,9,9,425,218,207,378,326,52,5
2021,Adur 008,E02006541,3693,2568,1530,1038,11,11,374,280,94,736,659,77,4
2021,Arun 001,E02006542,2643,1898,1216,682,8,8,230,129,101,505,403,102,2
2021,Arun 002,E02006543,2491,1927,1190,737,14,14,214,180,34,336,277,59,0
2021,Arun 003,E02006544,4734,3722,2073,1649,53,53,345,214,131,607,529,78,7
2021,Arun 004,E02006545,4789,2851,1276,1575,195,195,996,516,480,742,672,70,5
2021,Arun 005,E02006546,4706,3507,1990,1517,91,91,578,297,281,527,459,68,3
2021,Arun 006,E02006547,2721,2048,1171,877,58,58,333,137,196,279,233,46,3
2021,Arun 007,E02006548,4248,3167,1786,1381,45,45,261,102,159,773,687,86,2
2021,Arun 008,E02006549,3005,2646,1957,689,11,11,60,30,30,287,241,46,1
2021,Arun 009,E02006550,4224,3292,2200,1092,20,20,346,167,179,559,480,79,7
2021,Arun 010,E02006551,4189,3422,2705,717,24,24,234,56,178,507,427,80,2
2021,Arun 011,E02006552,3630,1621,983,638,37,37,318,94,224,1652,1545,107,2
2021,Arun 012,E02006553,4049,2970,1550,1420,106,106,307,88,219,665,595,70,1
2021,Arun 013,E02006554,3141,2518,1700,818,17,17,149,102,47,454,392,62,3
2021,Arun 014,E02006555,3234,1768,932,836,23,23,657,363,294,781,708,73,5
2021,Arun 015,E02006556,4512,3648,2336,1312,27,27,270,59,211,567,499,68,0
2021,Arun 016,E02006557,3016,1616,763,853,37,37,694,397,297,662,597,65,7
2021,Arun 017,E02006558,5047,2155,1381,774,50,50,407,176,231,2430,2287,143,5
2021,Arun 018,E02006559,3850,3379,2538,841,3,3,50,17,33,417,361,56,1
2021,Arun 019,E02006560,4425,3612,2435,1177,15,15,325,85,240,472,410,62,1
2021,Chichester 001,E02006561,2648,1920,1034,886,23,23,398,61,337,305,231,74,2
2021,Chichester 002,E02006562,2530,1987,1129,858,17,17,235,22,213,291,220,71,0
2021,Chichester 003,E02006563,2428,1751,1048,703,7,7,315,48,267,355,264,91,0
2021,Chichester 004,E02006564,3817,2401,1510,891,48,48,677,93,584,690,582,108,1
2021,Chichester 005,E02006565,3554,2211,1460,751,13,13,495,75,420,834,638,196,1
2021,Chichester 006,E02006566,3673,2516,1692,824,55,55,510,58,452,587,487,100,5
2021,Chichester 007,E02006567,3346,2413,1492,921,36,36,417,94,323,477,388,89,3
2021,Chichester 008,E02006568,5393,2304,1488,816,184,184,1609,224,1385,1290,1117,173,6
2021,Chichester 009,E02006569,3725,2628,1744,884,64,64,328,26,302,702,452,250,3
2021,Chichester 010,E02006570,4349,2240,1548,692,53,53,714,82,632,1339,1228,111,3
2021,Chichester 011,E02006571,3637,2617,1656,961,44,44,382,49,333,594,517,77,0
2021,Chichester 012,E02006572,4728,2745,1533,1212,110,110,1121,136,985,749,648,101,3
2021,Chichester 013,E02006573,5216,3810,2634,1176,61,61,515,52,463,830,672,158,0
2021,Chichester 014,E02006574,5077,3830,2747,1083,38,38,444,38,406,765,645,120,0
2021,Crawley 001,E02006575,3013,1549,701,848,32,32,848,574,274,573,514,59,11
2021,Crawley 002,E02006576,4194,3152,1225,1927,24,24,419,355,64,591,543,48,8
2021,Crawley 003,E02006577,3541,1822,792,1030,72,72,1088,988,100,540,480,60,19
2021,Crawley 004,E02006578,5044,2031,955,1076,110,110,1135,832,303,1751,1648,103,17
2021,Crawley 005,E02006579,3301,1932,904,1028,47,47,581,453,128,730,690,40,11
2021,Crawley 006,E02006580,3264,2121,978,1143,19,19,641,561,80,472,419,53,11
2021,Crawley 007,E02006581,4217,2103,954,1149,61,61,1019,555,464,1030,957,73,4
2021,Crawley 008,E02006582,2977,2309,993,1316,39,39,117,30,87,511,477,34,1
2021,Crawley 009,E02006583,3810,2389,1143,1246,31,31,639,533,106,741,700,41,10
2021,Crawley 010,E02006584,2947,1384,488,896,40,40,1069,986,83,440,406,34,14
2021,Crawley 011,E02006585,3083,1756,804,952,19,19,883,825,58,411,357,54,14
2021,Crawley 012,E02006586,2667,1398,479,919,20,20,684,642,42,561,525,36,4
2021,Crawley 013,E02006587,3449,1419,526,893,47,47,1309,634,675,666,635,31,8
2021,Horsham 001,E02006588,4485,2843,1268,1575,137,137,610,44,566,892,797,95,3
2021,Horsham 002,E02006589,4635,3759,1983,1776,63,63,286,21,265,526,479,47,1
2021,Horsham 003,E02006590,3813,2556,1335,1221,48,48,546,73,473,662,585,77,1
2021,Horsham 004,E02006591,3655,2504,1268,1236,27,27,421,48,373,700,621,79,3
2021,Horsham 005,E02006592,2561,2021,1111,910,31,31,227,25,202,282,204,78,0
2021,Horsham 006,E02006593,5235,2772,1459,1313,89,89,1131,128,1003,1238,1136,102,5
2021,Horsham 007,E02006594,4531,3273,1459,1814,101,101,539,59,480,616,554,62,2
2021,Horsham 008,E02006595,3359,2663,1570,1093,32,32,157,16,141,506,377,129,1
2021,Horsham 009,E02006596,3775,2978,1417,1561,122,122,346,36,310,327,281,46,2
2021,Horsham 010,E02006597,5151,3597,1743,1854,167,167,668,71,597,719,613,106,0
2021,Horsham 011,E02006598,2258,1790,1002,788,9,9,156,12,144,303,239,64,0
2021,Horsham 012,E02006599,3106,2751,1893,858,16,16,120,14,106,217,170,47,2
2021,Horsham 013,E02006600,4673,3095,1888,1207,53,53,880,113,767,642,541,101,3
2021,Horsham 014,E02006601,3894,2693,1613,1080,82,82,634,60,574,484,406,78,1
2021,Horsham 015,E02006602,3430,2662,1459,1203,78,78,280,39,241,410,333,77,0
2021,Horsham 016,E02006603,3817,3111,2011,1100,19,19,155,19,136,532,459,73,0
2021,Mid Sussex 001,E02006604,5949,3607,1794,1813,56,56,968,89,879,1318,1214,104,0
2021,Mid Sussex 002,E02006605,2476,1943,965,978,23,23,147,7,140,363,295,68,0
2021,Mid Sussex 003,E02006606,3412,2766,1463,1303,41,41,144,10,134,460,414,46,1
2021,Mid Sussex 004,E02006607,3219,2713,1475,1238,17,17,147,14,133,342,295,47,0
2021,Mid Sussex 005,E02006608,2609,2190,1238,952,43,43,199,11,188,177,145,32,0
2021,Mid Sussex 006,E02006609,2735,2090,1129,961,11,11,266,12,254,368,276,92,0
2021,Mid Sussex 007,E02006610,3186,2179,1037,1142,46,46,344,14,330,617,491,126,0
2021,Mid Sussex 008,E02006611,4652,3799,2061,1738,44,44,286,23,263,523,456,67,0
2021,Mid Sussex 009,E02006612,5398,3166,1430,1736,79,79,484,38,446,1668,1554,114,1
2021,Mid Sussex 010,E02006613,3282,1950,893,1057,47,47,805,58,747,480,441,39,0
2021,Mid Sussex 011,E02006614,5224,3678,1680,1998,132,132,697,45,652,717,655,62,0
2021,Mid Sussex 012,E02006615,2781,2113,900,1213,53,53,229,10,219,386,361,25,0
2021,Mid Sussex 013,E02006616,4060,3135,1457,1678,84,84,443,22,421,397,350,47,1
2021,Mid Sussex 014,E02006617,4068,2517,1269,1248,30,30,734,53,681,787,705,82,0
2021,Mid Sussex 015,E02006618,2576,2269,1280,989,28,28,68,7,61,211,182,29,0
2021,Mid Sussex 016,E02006619,3462,2441,1205,1236,41,41,513,29,484,467,367,100,0
2021,Mid Sussex 017,E02006620,4256,3459,1985,1474,34,34,338,16,322,425,366,59,0
2021,Worthing 001,E02006621,3359,3064,1955,1109,7,7,62,21,41,226,196,30,0
2021,Worthing 002,E02006622,3433,2635,1477,1158,9,9,329,56,273,460,404,56,0
2021,Worthing 003,E02006623,3455,2301,1243,1058,16,16,652,130,522,486,433,53,0
2021,Worthing 004,E02006624,2862,2508,1270,1238,4,4,27,4,23,323,292,31,0
2021,Worthing 005,E02006625,3305,2451,1093,1358,27,27,155,25,130,672,614,58,0
2021,Worthing 006,E02006626,3915,2345,892,1453,102,102,950,207,743,513,450,63,5
2021,Worthing 007,E02006627,4247,3104,1609,1495,35,35,415,104,311,692,626,66,1
2021,Worthing 008,E02006628,3960,2310,979,1331,20,20,465,89,376,1165,1081,84,0
2021,Worthing 009,E02006629,3301,2031,1026,1005,15,15,535,159,376,718,644,74,2
2021,Worthing 010,E02006630,4521,2250,1327,923,23,23,489,97,392,1755,1662,93,4
2021,Worthing 011,E02006631,5446,2355,1297,1058,29,29,455,72,383,2605,2466,139,2
2021,Worthing 012,E02006632,3890,2923,1732,1191,19,19,118,28,90,830,736,94,0
2021,Worthing 013,E02006633,3838,3161,2150,1011,9,9,190,59,131,477,408,69,1
2021,Wiltshire 012,E02006634,3626,2444,1488,956,26,26,490,52,438,664,477,187,2
2021,Wiltshire 019,E02006635,3680,2299,1527,772,42,42,720,118,602,617,485,132,2
2021,Wiltshire 024,E02006636,3218,2155,1340,815,22,22,499,77,422,539,413,126,3
2021,Wiltshire 025,E02006637,4835,3064,1612,1452,114,114,920,137,783,737,615,122,0
2021,Wiltshire 026,E02006638,3223,1866,1275,591,17,17,898,112,786,441,387,54,1
2021,Wiltshire 028,E02006639,3507,2561,1555,1006,23,23,543,61,482,377,274,103,3
2021,Wiltshire 029,E02006640,3098,2130,1212,918,48,48,395,49,346,525,380,145,0
2021,Wiltshire 034,E02006641,3448,2462,1389,1073,89,89,518,57,461,379,294,85,0
2021,Wiltshire 038,E02006642,2439,1667,1009,658,9,9,336,43,293,427,249,178,0
2021,Wiltshire 001,E02006644,2938,2268,1381,887,58,58,300,42,258,311,263,48,1
2021,Wiltshire 002,E02006645,3357,2162,1201,961,36,36,492,43,449,667,586,81,0
2021,Wiltshire 003,E02006646,3232,2517,1185,1332,62,62,340,33,307,311,252,59,2
2021,Wiltshire 004,E02006647,2470,2034,1225,809,13,13,129,22,107,293,207,86,1
2021,Wiltshire 005,E02006648,2630,1899,1136,763,21,21,189,32,157,520,332,188,1
2021,Wiltshire 006,E02006649,3343,2162,1157,1005,45,45,562,75,487,572,514,58,2
2021,Wiltshire 007,E02006650,4988,3530,1983,1547,48,48,386,60,326,1024,565,459,0
2021,Wiltshire 008,E02006651,2949,2297,1339,958,19,19,220,24,196,413,284,129,0
2021,Wiltshire 009,E02006652,3942,2838,1400,1438,25,25,467,46,421,611,532,79,1
2021,Wiltshire 010,E02006653,4118,2983,1556,1427,52,52,532,85,447,548,477,71,3
2021,Wiltshire 011,E02006654,4587,2513,1456,1057,59,59,1096,102,994,914,802,112,5
2021,Wiltshire 013,E02006655,3352,2559,1331,1228,68,68,255,33,222,470,378,92,0
2021,Wiltshire 014,E02006656,2896,2102,1015,1087,21,21,204,26,178,569,512,57,0
2021,Wiltshire 015,E02006657,4510,2773,1211,1562,98,98,958,133,825,681,597,84,0
2021,Wiltshire 016,E02006658,3634,2651,1394,1257,64,64,470,53,417,448,387,61,1
2021,Wiltshire 017,E02006659,3384,2401,1299,1102,49,49,328,47,281,606,304,302,0
2021,Wiltshire 018,E02006660,5855,3955,2213,1742,76,76,963,136,827,857,693,164,4
2021,Wiltshire 045,E02006661,3131,1217,641,576,14,14,324,177,147,1575,345,1230,1
2021,Wiltshire 046,E02006662,2881,1725,901,824,16,16,442,301,141,694,327,367,4
2021,Wiltshire 048,E02006663,5336,3236,1531,1705,170,170,1039,470,569,886,682,204,5
2021,Wiltshire 049,E02006664,2708,2005,1219,786,11,11,255,213,42,434,296,138,3
2021,Wiltshire 050,E02006665,3073,2098,1425,673,27,27,416,292,124,530,421,109,2
2021,Wiltshire 051,E02006666,2843,1955,1023,932,50,50,525,275,250,310,266,44,3
2021,Wiltshire 052,E02006667,3003,1506,637,869,85,85,1111,783,328,296,243,53,5
2021,Wiltshire 053,E02006668,2554,1810,1068,742,22,22,419,315,104,298,234,64,5
2021,Wiltshire 054,E02006669,4750,3063,1849,1214,47,47,663,436,227,969,753,216,8
2021,Wiltshire 055,E02006670,3256,1896,974,922,80,80,341,109,232,939,848,91,0
2021,Wiltshire 056,E02006671,2960,1652,998,654,26,26,301,153,148,979,883,96,2
2021,Wiltshire 057,E02006672,3796,2385,1238,1147,188,188,598,132,466,622,407,215,3
2021,Wiltshire 058,E02006673,2514,1497,998,499,9,9,444,247,197,559,462,97,5
2021,Wiltshire 059,E02006674,2556,1433,836,597,59,59,579,275,304,481,400,81,4
2021,Wiltshire 060,E02006675,3360,2743,1613,1130,26,26,196,134,62,394,307,87,1
2021,Wiltshire 061,E02006676,2788,1895,1302,593,23,23,398,293,105,469,379,90,3
2021,Wiltshire 062,E02006677,3350,2627,1604,1023,32,32,246,176,70,441,357,84,4
2021,Wiltshire 020,E02006678,3318,2392,1301,1091,17,17,519,73,446,388,333,55,2
2021,Wiltshire 021,E02006679,5011,3873,1944,1929,40,40,593,53,540,505,394,111,0
2021,Wiltshire 022,E02006680,3471,2240,1307,933,16,16,633,73,560,580,507,73,2
2021,Wiltshire 023,E02006681,2585,2028,1280,748,4,4,268,35,233,283,222,61,2
2021,Wiltshire 027,E02006682,4772,3475,2217,1258,30,30,689,87,602,578,492,86,0
2021,Wiltshire 030,E02006683,3309,2446,1239,1207,8,8,381,55,326,474,411,63,0
2021,Wiltshire 031,E02006684,3218,1749,947,802,21,21,601,107,494,843,771,72,4
2021,Wiltshire 032,E02006685,4241,2993,1484,1509,25,25,511,62,449,712,633,79,0
2021,Wiltshire 033,E02006686,2191,1456,825,631,5,5,507,74,433,222,174,48,1
2021,Wiltshire 035,E02006687,3454,2148,1032,1116,53,53,683,141,542,564,486,78,6
2021,Wiltshire 036,E02006688,2487,1757,913,844,15,15,211,38,173,503,435,68,1
2021,Wiltshire 037,E02006689,2922,2349,1398,951,12,12,210,34,176,351,281,70,0
2021,Wiltshire 039,E02006690,3064,2439,1436,1003,19,19,246,31,215,359,272,87,1
2021,Wiltshire 042,E02006692,2286,1306,854,452,7,7,383,47,336,590,254,336,0
2021,Wiltshire 043,E02006693,2802,1986,1078,908,24,24,441,51,390,349,301,48,2
2021,Wiltshire 044,E02006694,2944,1906,1200,706,14,14,365,43,322,656,564,92,3
2021,Wiltshire 047,E02006695,2811,1975,1287,688,9,9,245,27,218,582,453,129,0
2021,Bromsgrove 001,E02006696,2874,2440,1302,1138,36,36,97,20,77,301,266,35,0
2021,Bromsgrove 002,E02006697,3087,2572,1570,1002,13,13,189,68,121,313,236,77,0
2021,Bromsgrove 003,E02006698,2691,2235,1261,974,21,21,172,49,123,261,236,25,2
2021,Bromsgrove 004,E02006699,2557,2013,1213,800,6,6,344,112,232,192,160,32,2
2021,Bromsgrove 005,E02006700,2575,2265,1327,938,40,40,101,25,76,169,130,39,0
2021,Bromsgrove 006,E02006701,2917,2572,1311,1261,42,42,87,18,69,216,169,47,0
2021,Bromsgrove 007,E02006702,2585,1739,918,821,46,46,495,148,347,302,250,52,3
2021,Bromsgrove 008,E02006703,3232,2741,1420,1321,42,42,198,65,133,251,202,49,0
2021,Bromsgrove 009,E02006704,2884,2317,1361,956,24,24,265,84,181,276,221,55,2
2021,Bromsgrove 010,E02006705,3160,2109,1078,1031,67,67,600,213,387,384,339,45,0
2021,Bromsgrove 011,E02006706,3273,2102,1273,829,29,29,584,178,406,554,481,73,4
2021,Bromsgrove 012,E02006707,2676,2346,1215,1131,12,12,76,20,56,241,217,24,1
2021,Bromsgrove 013,E02006708,3452,1922,887,1035,32,32,967,389,578,528,480,48,3
2021,Bromsgrove 014,E02006709,3312,2626,1352,1274,44,44,243,63,180,398,336,62,1
2021,Malvern Hills 001,E02006710,3654,2611,1732,879,31,31,439,40,399,573,468,105,0
2021,Malvern Hills 002,E02006711,3524,2724,1695,1029,33,33,337,42,295,429,326,103,1
2021,Malvern Hills 003,E02006712,3192,2592,1567,1025,41,41,251,42,209,308,238,70,0
2021,Malvern Hills 004,E02006713,3036,1987,1337,650,44,44,512,69,443,491,434,57,2
2021,Malvern Hills 005,E02006714,2503,1939,1200,739,21,21,239,33,206,303,252,51,1
2021,Malvern Hills 006,E02006715,3799,2694,1508,1186,73,73,519,73,446,512,433,79,1
2021,Malvern Hills 007,E02006716,2799,1232,752,480,87,87,1249,237,1012,228,199,29,3
2021,Malvern Hills 008,E02006717,2944,2308,1347,961,26,26,346,58,288,263,208,55,1
2021,Malvern Hills 009,E02006718,2802,1922,1358,564,47,47,476,86,390,356,309,47,1
2021,Malvern Hills 010,E02006719,3418,2466,1729,737,22,22,199,16,183,731,652,79,0
2021,Malvern Hills 011,E02006720,3229,2301,1528,773,28,28,435,58,377,464,380,84,1
2021,Redditch 001,E02006721,2792,2150,1177,973,68,68,329,123,206,245,217,28,0
2021,Redditch 002,E02006722,2322,1013,394,619,7,7,909,733,176,383,336,47,10
2021,Redditch 003,E02006723,3857,2132,780,1352,52,52,1239,911,328,421,367,54,13
2021,Redditch 004,E02006724,2788,1088,456,632,16,16,829,592,237,842,792,50,13
2021,Redditch 005,E02006725,2396,1424,700,724,1,1,696,564,132,269,241,28,6
2021,Redditch 006,E02006726,2642,1664,814,850,11,11,364,268,96,599,548,51,4
2021,Redditch 007,E02006727,2491,1991,1032,959,9,9,199,100,99,289,258,31,3
2021,Redditch 008,E02006728,3268,2550,1285,1265,31,31,328,191,137,357,319,38,2
2021,Redditch 009,E02006729,3035,2166,1020,1146,50,50,487,412,75,326,271,55,6
2021,Redditch 010,E02006730,2607,1285,509,776,25,25,844,669,175,448,419,29,5
2021,Redditch 011,E02006731,2605,1595,816,779,5,5,644,377,267,353,324,29,8
2021,Redditch 012,E02006732,2994,2430,1241,1189,9,9,201,170,31,348,306,42,6
2021,Redditch 013,E02006733,2587,1950,1030,920,10,10,262,174,88,365,322,43,0
2021,Worcester 001,E02006734,3550,2908,1643,1265,13,13,148,36,112,481,416,65,0
2021,Worcester 002,E02006735,2423,803,402,401,26,26,1364,527,837,220,197,23,10
2021,Worcester 003,E02006736,2814,1987,872,1115,5,5,174,35,139,648,606,42,0
2021,Worcester 004,E02006737,3717,2565,1326,1239,33,33,431,100,331,687,620,67,1
2021,Worcester 005,E02006738,3718,1690,833,857,81,81,1265,470,795,675,617,58,7
2021,Worcester 006,E02006739,2109,1541,949,592,5,5,111,25,86,452,411,41,0
2021,Worcester 007,E02006740,3845,1722,925,797,16,16,480,66,414,1627,1505,122,0
2021,Worcester 008,E02006741,2455,1704,744,960,28,28,218,35,183,505,464,41,0
2021,Worcester 009,E02006742,3771,1870,982,888,70,70,1019,319,700,811,729,82,1
2021,Worcester 010,E02006743,2693,1619,763,856,41,41,613,233,380,418,366,52,2
2021,Worcester 011,E02006744,3457,1540,805,735,35,35,677,145,532,1203,1106,97,2
2021,Worcester 012,E02006745,3730,2808,1568,1240,44,44,362,78,284,515,434,81,1
2021,Worcester 013,E02006746,3959,2772,1453,1319,61,61,322,74,248,803,711,92,1
2021,Worcester 014,E02006747,2479,1934,1056,878,13,13,84,13,71,448,410,38,0
2021,Wychavon 001,E02006748,3653,2645,1345,1300,76,76,517,95,422,414,325,89,1
2021,Wychavon 002,E02006749,2244,1106,565,541,11,11,802,157,645,325,284,41,0
2021,Wychavon 003,E02006750,2675,1736,1089,647,16,16,494,81,413,428,384,44,1
2021,Wychavon 004,E02006751,2603,1614,938,676,20,20,679,142,537,289,245,44,1
2021,Wychavon 005,E02006752,3450,2820,1480,1340,61,61,357,79,278,212,178,34,0
2021,Wychavon 006,E02006753,3076,2403,1388,1015,19,19,348,83,265,306,230,76,0
2021,Wychavon 007,E02006754,2417,1943,1140,803,18,18,161,20,141,294,242,52,1
2021,Wychavon 008,E02006755,2475,2073,1272,801,20,20,141,6,135,241,178,63,0
2021,Wychavon 009,E02006756,2719,2063,947,1116,51,51,319,53,266,286,242,44,0
2021,Wychavon 010,E02006757,3148,2435,1569,866,14,14,361,50,311,336,252,84,2
2021,Wychavon 011,E02006758,2503,1861,1020,841,27,27,396,61,335,219,173,46,0
2021,Wychavon 012,E02006759,3971,2553,1675,878,77,77,818,101,717,522,442,80,1
2021,Wychavon 013,E02006760,3883,2818,1701,1117,61,61,651,106,545,351,284,67,2
2021,Wychavon 014,E02006761,3061,1181,661,520,33,33,809,139,670,1037,962,75,1
2021,Wychavon 015,E02006762,3111,2161,1164,997,59,59,419,73,346,469,418,51,3
2021,Wychavon 016,E02006763,3466,2494,1319,1175,76,76,426,63,363,470,412,58,0
2021,Wychavon 017,E02006764,2468,1400,702,698,26,26,584,92,492,456,412,44,2
2021,Wychavon 018,E02006765,2994,2200,1502,698,31,31,378,50,328,384,310,74,1
2021,Wychavon 019,E02006766,3440,2679,1710,969,13,13,293,26,267,454,363,91,1
2021,Wyre Forest 001,E02006767,4082,3035,1873,1162,34,34,580,261,319,425,347,78,8
2021,Wyre Forest 002,E02006768,2998,2279,1327,952,24,24,241,97,144,447,393,54,7
2021,Wyre Forest 003,E02006769,3063,2492,1325,1167,8,8,65,21,44,498,445,53,0
2021,Wyre Forest 004,E02006770,3815,1647,766,881,31,31,1041,501,540,1092,1018,74,4
2021,Wyre Forest 005,E02006771,3103,2307,1558,749,44,44,337,141,196,413,334,79,2
2021,Wyre Forest 006,E02006772,2919,1982,1162,820,48,48,508,210,298,378,336,42,3
2021,Wyre Forest 007,E02006773,3794,2365,1436,929,45,45,690,333,357,686,611,75,8
2021,Wyre Forest 008,E02006774,3447,2180,1137,1043,20,20,397,171,226,847,778,69,3
2021,Wyre Forest 009,E02006775,2528,1173,538,635,49,49,1000,556,444,298,260,38,8
2021,Wyre Forest 010,E02006776,2843,2097,1260,837,23,23,297,74,223,425,373,52,1
2021,Wyre Forest 011,E02006777,3364,2711,1875,836,21,21,179,52,127,453,374,79,0
2021,Wyre Forest 012,E02006778,3013,2416,1390,1026,30,30,232,120,112,333,271,62,2
2021,Wyre Forest 013,E02006779,3641,2538,1517,1021,63,63,332,137,195,707,635,72,1
2021,Wyre Forest 014,E02006780,2721,1941,1315,626,25,25,513,272,241,239,191,48,3
2021,Isles of Scilly 001,E02006781,939,418,320,98,14,14,162,103,59,344,224,120,1
2021,Bromley 040,E02006782,3198,2159,1028,1131,31,31,583,46,537,423,377,46,2
2021,Lewisham 037,E02006783,2895,1184,414,770,17,17,1102,324,778,586,549,37,6
2021,Lewisham 038,E02006784,3126,1442,597,845,23,23,1125,262,863,534,470,64,2
2021,Bexley 029,E02006785,2574,1827,886,941,25,25,385,70,315,336,296,40,1
2021,Greenwich 033,E02006786,2873,1298,571,727,49,49,938,562,376,583,508,75,5
2021,Bromley 041,E02006787,3091,2292,1034,1258,34,34,279,30,249,486,446,40,0
2021,Croydon 045,E02006788,2894,1548,558,990,12,12,910,635,275,420,373,47,4
2021,Bromley 042,E02006789,2788,2357,1471,886,16,16,145,13,132,270,198,72,0
2021,Tandridge 012,E02006790,3159,2505,1390,1115,9,9,322,257,65,319,275,44,4
2021,Ealing 040,E02006791,3449,1626,647,979,37,37,481,271,210,1299,1241,58,6
2021,Hounslow 029,E02006792,4148,1790,953,837,33,33,447,303,144,1873,1773,100,5
2021,Enfield 037,E02006793,3390,924,414,510,45,45,1431,891,540,954,901,53,36
2021,Haringey 037,E02006794,3125,538,242,296,164,164,1430,838,592,968,898,70,25
2021,Harrow 032,E02006795,2644,1747,879,868,11,11,80,47,33,805,745,60,1
2021,Hillingdon 033,E02006796,3579,2299,1025,1274,37,37,334,264,70,902,835,67,7
2021,Lewisham 039,E02006798,3774,910,268,642,52,52,1619,1041,578,1181,1093,88,12
2021,Barking and Dagenham 023,E02006799,3890,1638,537,1101,75,75,1188,886,302,981,912,69,8
2021,Redbridge 034,E02006800,4514,2206,1066,1140,42,42,385,194,191,1872,1727,145,9
2021,Lambeth 036,E02006801,3712,769,405,364,53,53,1373,603,770,1512,1378,134,5
2021,Southwark 034,E02006802,3939,876,349,527,183,183,1677,1066,611,1197,1097,100,6
2021,Sheffield 072,E02006803,4021,3246,1614,1632,22,22,260,222,38,490,415,75,3
2021,North East Derbyshire 014,E02006804,3669,2017,1023,994,21,21,1088,925,163,529,458,71,14
2021,Coventry 043,E02006805,3325,1877,819,1058,24,24,623,194,429,798,722,76,3
2021,Nuneaton and Bedworth 018,E02006806,3492,2505,1278,1227,31,31,428,278,150,527,447,80,1
2021,Birmingham 132,E02006807,3028,2432,1221,1211,12,12,60,38,22,521,466,55,3
2021,Solihull 030,E02006808,2671,2145,995,1150,33,33,122,80,42,369,335,34,2
2021,Birmingham 133,E02006809,3143,2482,1340,1142,6,6,133,52,81,508,426,82,14
2021,Sandwell 039,E02006810,4312,2745,1651,1094,15,15,831,760,71,704,625,79,17
2021,Middlesbrough 020,E02006811,4730,3991,2112,1879,29,29,166,32,134,541,464,77,3
2021,Redcar and Cleveland 021,E02006812,3449,2314,1340,974,12,12,720,358,362,400,326,74,3
2021,Kingston upon Hull 033,E02006813,3815,1983,1030,953,91,91,1171,917,254,552,497,55,18
2021,East Riding of Yorkshire 043,E02006814,3538,2683,1472,1211,9,9,276,248,28,568,508,60,2
2021,Leicester 037,E02006815,4129,2341,999,1342,31,31,1271,1122,149,464,391,73,22
2021,Harborough 011,E02006816,3493,2861,1506,1355,113,113,207,16,191,310,257,53,2
2021,Leicester 038,E02006817,3205,1910,968,942,8,8,448,218,230,836,773,63,3
2021,Oadby and Wigston 008,E02006818,3321,2821,1642,1179,13,13,72,58,14,415,363,52,0
2021,Leicester 039,E02006819,3225,1281,563,718,32,32,1462,1123,339,428,392,36,22
2021,Blaby 013,E02006820,4491,3685,2101,1584,31,31,264,40,224,508,414,94,3
2021,Portsmouth 026,E02006821,2623,2051,1048,1003,8,8,131,81,50,430,280,150,3
2021,Havant 018,E02006822,3809,2986,1578,1408,25,25,386,143,243,410,341,69,2
2021,Buckinghamshire 039,E02006823,3531,2955,1697,1258,22,22,233,28,205,321,268,53,0
2021,Buckinghamshire 036,E02006824,3802,3222,1732,1490,17,17,226,20,206,337,283,54,0
2021,East Cambridgeshire 011,E02006825,2735,1821,1094,727,42,42,324,37,287,548,286,262,0
2021,West Suffolk 015,E02006826,4803,2384,1355,1029,22,22,860,331,529,1534,1336,198,3
2021,Amber Valley 017,E02006827,3626,1878,1018,860,17,17,1004,370,634,720,655,65,7
2021,Erewash 016,E02006828,3020,2299,1118,1181,39,39,231,67,164,451,397,54,0
2021,East Hampshire 016,E02006829,3208,2596,1504,1092,64,64,196,20,176,351,294,57,1
2021,Havant 019,E02006830,2795,1565,766,799,59,59,846,550,296,315,269,46,10
2021,Havant 020,E02006831,2689,2307,1381,926,6,6,136,28,108,240,212,28,0
2021,Sevenoaks 016,E02006832,2463,1853,998,855,33,33,187,28,159,390,340,50,0
2021,Tonbridge and Malling 014,E02006833,5147,3658,1786,1872,109,109,769,112,657,610,499,111,1
2021,Nottingham 038,E02006834,3515,1561,784,777,4,4,1469,1201,268,466,407,59,15
2021,Gedling 016,E02006835,2619,1988,1051,937,14,14,251,163,88,366,314,52,0
2021,Sutton 025,E02006836,3212,2605,1319,1286,35,35,78,28,50,494,449,45,0
2021,Epsom and Ewell 010,E02006837,4440,3560,1813,1747,33,33,241,13,228,606,529,77,0
2021,East Hampshire 017,E02006838,2995,2510,1529,981,25,25,198,45,153,261,209,52,1
2021,Waverley 018,E02006839,3435,2638,1447,1191,24,24,298,193,105,471,362,109,4
2021,Torbay 019,E02006840,4787,3348,1932,1416,13,13,282,33,249,1144,1048,96,0
2021,Gateshead 027,E02006841,3692,1244,443,801,5,5,1069,917,152,1356,1258,98,18
2021,Gateshead 028,E02006842,2242,1071,578,493,3,3,418,246,172,746,699,47,4
2021,Sheffield 073,E02006843,4055,658,219,439,6,6,511,170,341,2875,2779,96,5
2021,Sheffield 074,E02006844,2706,329,181,148,12,12,687,218,469,1673,1608,65,5
2021,North Somerset 026,E02006845,3939,2669,976,1693,52,52,321,53,268,896,809,87,1
2021,North Somerset 027,E02006846,3876,2338,566,1772,67,67,347,39,308,1124,1064,60,0
2021,Swindon 026,E02006847,3665,2629,699,1930,84,84,169,24,145,782,738,44,1
2021,Swindon 027,E02006848,3414,2000,439,1561,59,59,225,21,204,1129,1048,81,1
2021,Swindon 028,E02006849,3931,3076,1078,1998,10,10,152,12,140,692,640,52,1
2021,Leicester 040,E02006850,2857,321,189,132,5,5,993,214,779,1532,1452,80,6
2021,Leicester 041,E02006851,3679,336,128,208,11,11,645,99,546,2685,2590,95,2
2021,Leeds 109,E02006852,4931,3067,1570,1497,21,21,220,80,140,1619,1524,95,4
2021,Tower Hamlets 032,E02006853,5040,914,318,596,130,130,1511,194,1317,2482,2356,126,3
2021,Tower Hamlets 033,E02006854,3528,863,337,526,78,78,510,94,416,2075,1974,101,2
2021,Canterbury 019,E02006855,2552,1016,456,560,26,26,592,431,161,907,852,55,11
2021,Canterbury 020,E02006856,4981,1974,1178,796,63,63,730,447,283,2210,2064,146,4
2021,Eastbourne 013,E02006857,3939,2709,1579,1130,18,18,441,235,206,769,693,76,2
2021,Eastbourne 014,E02006858,3271,2055,1341,714,28,28,227,21,206,961,900,61,0
2021,Thurrock 019,E02006859,2650,1760,362,1398,5,5,23,7,16,862,815,47,0
2021,Leeds 110,E02006861,4449,852,394,458,20,20,600,139,461,2977,2901,76,0
2021,North Northamptonshire 009,E02006862,2666,1842,927,915,23,23,387,326,61,407,354,53,7
2021,North Northamptonshire 008,E02006863,4173,2803,668,2135,19,19,305,29,276,1046,985,61,0
2021,Boston 008,E02006864,3649,2787,1694,1093,60,60,248,83,165,554,489,65,0
2021,Boston 009,E02006865,3418,2632,1522,1110,55,55,235,76,159,494,431,63,2
2021,North Kesteven 013,E02006866,3697,2679,1214,1465,57,57,387,190,197,571,497,74,3
2021,North Kesteven 014,E02006867,3691,2976,1720,1256,26,26,210,142,68,478,403,75,1
2021,Sheffield 075,E02006868,5043,1800,956,844,24,24,2104,409,1695,1095,973,122,20
2021,Sheffield 076,E02006869,4818,2989,1438,1551,74,74,1244,972,272,508,428,80,3
2021,Lancaster 020,E02006871,5279,3905,2215,1690,20,20,678,396,282,672,552,120,4
2021,High Peak 013,E02006872,5796,4322,2603,1719,85,85,579,421,158,805,655,150,5
2021,South Cambridgeshire 020,E02006873,3512,1980,511,1469,282,282,593,61,532,655,608,47,2
2021,South Cambridgeshire 021,E02006874,4030,2775,1129,1646,130,130,657,210,447,464,401,63,4
2021,Leeds 111,E02006875,3746,728,234,494,21,21,334,69,265,2661,2539,122,2
2021,Leeds 112,E02006876,3710,1232,469,763,14,14,858,597,261,1602,1528,74,4
2021,Peterborough 022,E02006877,4384,2768,1043,1725,91,91,620,102,518,904,822,82,1
2021,Peterborough 023,E02006878,4614,2727,620,2107,126,126,694,154,540,1064,996,68,3
2021,Folkestone and Hythe 014,E02006879,3545,959,558,401,29,29,514,259,255,2037,1954,83,6
2021,Folkestone and Hythe 015,E02006880,3507,1607,959,648,6,6,155,38,117,1739,1650,89,0
2021,Burnley 014,E02006881,4566,2955,1595,1360,13,13,601,165,436,996,889,107,1
2021,Harrow 033,E02006882,4396,3176,1845,1331,53,53,137,91,46,1028,937,91,2
2021,"Bournemouth, Christchurch and Poole 040",E02006883,3249,1457,819,638,19,19,306,153,153,1464,1382,82,3
2021,Rossendale 010,E02006884,5605,3405,1767,1638,6,6,1144,300,844,1045,914,131,5
2021,"Bournemouth, Christchurch and Poole 045",E02006885,3970,1964,1262,702,57,57,92,26,66,1857,1726,131,0
2021,Vale of White Horse 016,E02006886,5635,3642,1912,1730,125,125,819,93,726,1048,571,477,1
2021,Bristol 054,E02006887,4561,784,274,510,100,100,1355,916,439,2303,2192,111,19
2021,Bristol 055,E02006888,2881,977,442,535,19,19,960,617,343,902,823,79,23
2021,Bristol 056,E02006889,3065,624,284,340,27,27,1818,1384,434,580,533,47,16
2021,Bristol 057,E02006890,3656,1860,760,1100,27,27,523,236,287,1237,1134,103,9
2021,East Riding of Yorkshire 044,E02006891,3580,2834,1700,1134,30,30,185,93,92,530,452,78,1
2021,East Riding of Yorkshire 045,E02006892,3023,1893,1167,726,11,11,325,258,67,791,708,83,3
2021,Newcastle upon Tyne 031,E02006893,4933,3850,2324,1526,6,6,563,373,190,510,410,100,4
2021,Wolverhampton 035,E02006894,5103,2132,1151,981,20,20,1347,742,605,1591,1409,182,13
2021,Birmingham 134,E02006895,4158,725,241,484,41,41,1382,310,1072,1998,1892,106,12
2021,Birmingham 135,E02006896,3158,468,179,289,47,47,846,211,635,1794,1696,98,3
2021,Birmingham 136,E02006897,4161,507,221,286,20,20,1665,864,801,1942,1870,72,27
2021,Birmingham 137,E02006898,4250,889,288,601,39,39,959,809,150,2353,2291,62,10
2021,Birmingham 138,E02006899,4065,711,225,486,19,19,609,115,494,2721,2630,91,5
2021,Birmingham 139,E02006900,4056,1976,1198,778,16,16,933,372,561,1116,996,120,15
2021,Manchester 054,E02006902,4357,760,257,503,35,35,810,365,445,2747,2657,90,5
2021,Bassetlaw 016,E02006903,5030,3327,1920,1407,14,14,1052,982,70,624,525,99,13
2021,Nottingham 039,E02006904,4180,924,413,511,24,24,546,237,309,2684,2570,114,2
2021,Nottingham 040,E02006905,3321,1177,597,580,24,24,1231,963,268,878,805,73,11
2021,Broxtowe 016,E02006906,5196,4314,2387,1927,6,6,184,141,43,690,607,83,2
2021,Norwich 014,E02006907,4308,1312,676,636,27,27,868,303,565,2097,1961,136,4
2021,Norwich 015,E02006908,3016,1222,649,573,13,13,888,576,312,890,838,52,3
2021,Hartlepool 014,E02006909,5509,4646,2677,1969,19,19,298,79,219,545,428,117,1
2021,Redcar and Cleveland 022,E02006910,4583,2948,1540,1408,33,33,1019,521,498,583,486,97,0
2021,Manchester 055,E02006912,5023,1049,353,696,45,45,458,110,348,3468,3336,132,3
2021,Manchester 056,E02006913,3185,811,356,455,18,18,806,407,399,1538,1467,71,12
2021,Manchester 057,E02006914,2210,355,123,232,8,8,513,88,425,1332,1283,49,2
2021,Manchester 058,E02006915,3038,694,268,426,10,10,1264,581,683,1058,997,61,12
2021,Manchester 059,E02006916,3802,794,251,543,11,11,1090,373,717,1903,1849,54,4
2021,Manchester 060,E02006917,3817,986,381,605,17,17,65,11,54,2748,2581,167,1
2021,Hackney 028,E02006918,3169,698,234,464,95,95,1359,593,766,1011,964,47,6
2021,South Derbyshire 012,E02006919,4481,3029,1131,1898,38,38,439,180,259,970,886,84,5
2021,South Derbyshire 013,E02006920,3334,2312,922,1390,16,16,427,252,175,575,527,48,4
2021,Hackney 029,E02006921,2784,475,213,262,19,19,1406,657,749,879,808,71,5
2021,Colchester 022,E02006922,5886,4205,2364,1841,26,26,724,497,227,924,836,88,7
2021,Redbridge 035,E02006924,4097,2519,1273,1246,18,18,228,98,130,1326,1210,116,6
2021,Redbridge 036,E02006925,4187,3120,1482,1638,5,5,154,88,66,902,827,75,6
2021,Thurrock 020,E02006926,2842,2187,644,1543,10,10,48,25,23,596,544,52,1
2021,Greenwich 034,E02006927,5086,2364,1058,1306,196,196,1238,690,548,1284,1207,77,4
2021,Greenwich 035,E02006928,5267,1293,332,961,252,252,1714,824,890,2005,1916,89,3
2021,Greenwich 037,E02006930,4227,1857,522,1335,164,164,909,397,512,1297,1218,79,0
2021,Greenwich 038,E02006931,4134,1761,734,1027,35,35,1197,750,447,1135,1050,85,6
2021,Liverpool 060,E02006932,3436,362,152,210,70,70,466,62,404,2537,2435,102,1
2021,Liverpool 061,E02006933,3876,797,368,429,26,26,650,176,474,2391,2305,86,12
2021,Liverpool 062,E02006934,3402,707,291,416,10,10,229,44,185,2455,2349,106,1
2021,St. Helens 024,E02006935,3288,1586,853,733,9,9,1208,432,776,481,430,51,4
2021,St. Helens 025,E02006936,3196,2112,808,1304,43,43,497,144,353,540,481,59,4
2021,Luton 022,E02006937,4041,988,444,544,34,34,651,352,299,2360,2239,121,8
2021,Luton 023,E02006938,2964,248,108,140,12,12,869,668,201,1823,1756,67,12
2021,Reading 019,E02006939,3379,681,235,446,84,84,404,131,273,2207,2140,67,3
2021,Reading 020,E02006940,3608,882,308,574,53,53,530,134,396,2137,2054,83,6
2021,Southwark 035,E02006941,2985,942,459,483,22,22,205,150,55,1815,1688,127,1
2021,Southwark 036,E02006942,3364,858,290,568,67,67,1033,730,303,1401,1296,105,5
2021,Sandwell 040,E02006943,2648,754,306,448,13,13,1223,852,371,605,554,51,53
2021,Sandwell 041,E02006944,2357,967,412,555,10,10,444,188,256,924,841,83,12
2021,Bradford 062,E02006945,3814,3106,1687,1419,18,18,167,79,88,521,445,76,2
2021,Bradford 063,E02006946,2458,1638,922,716,13,13,140,56,84,666,607,59,1
2021,Bradford 064,E02006947,3378,864,513,351,17,17,1148,295,853,1347,1223,124,2
2021,Bradford 065,E02006948,2688,398,236,162,4,4,615,205,410,1669,1604,65,2
2021,Bristol 058,E02006949,2800,1317,601,716,16,16,578,225,353,879,790,89,10
2021,Bristol 059,E02006950,3291,735,254,481,106,106,1060,398,662,1382,1298,84,8
2021,Bristol 060,E02006951,2935,638,304,334,52,52,313,60,253,1931,1845,86,1
2021,Bristol 061,E02006952,2818,942,442,500,54,54,391,221,170,1423,1319,104,8
2021,Barnet 042,E02006953,3857,1098,321,777,153,153,594,66,528,2003,1906,97,9
2021,Barnet 043,E02006954,3720,1308,576,732,154,154,763,181,582,1491,1397,94,4
2021,Brent 035,E02006955,2710,507,185,322,131,131,508,103,405,1561,1472,89,3
2021,Brent 036,E02006956,2505,1170,711,459,31,31,270,69,201,1028,962,66,6
2021,Salford 031,E02006957,2673,509,258,251,8,8,1370,502,868,768,705,63,18
2021,Salford 032,E02006958,3071,699,264,435,29,29,1234,246,988,1100,1033,67,9
2021,Salford 033,E02006959,4635,744,262,482,16,16,823,309,514,3047,2955,92,5
2021,Salford 034,E02006960,3796,872,244,628,13,13,1126,459,667,1777,1730,47,8
2021,Salford 035,E02006961,3151,615,223,392,4,4,1165,561,604,1355,1294,61,12
2021,Salford 036,E02006962,2475,384,145,239,6,6,506,270,236,1573,1552,21,6
2021,Salford 037,E02006963,3458,581,209,372,4,4,148,38,110,2725,2640,85,0
2021,Leicester 042,E02006964,2217,1199,344,855,59,59,171,37,134,787,748,39,1
2021,Leicester 043,E02006965,2805,1693,797,896,31,31,430,108,322,649,576,73,2
2021,Oadby and Wigston 010,E02006966,2034,1665,947,718,0,0,52,13,39,317,283,34,0
2021,Oadby and Wigston 011,E02006967,2751,2219,1219,1000,12,12,63,37,26,457,419,38,0
2021,Ealing 041,E02006968,3560,1550,899,651,16,16,387,44,343,1607,1478,129,0
2021,Ealing 042,E02006969,2976,843,391,452,93,93,355,107,248,1678,1605,73,7
2021,Ealing 043,E02006970,2029,721,333,388,80,80,234,68,166,989,888,101,5
2021,Ealing 044,E02006971,2223,1018,590,428,31,31,307,74,233,865,785,80,2
2021,Hounslow 030,E02006972,2334,676,292,384,87,87,853,601,252,712,668,44,6
2021,Hounslow 031,E02006973,3726,1257,537,720,122,122,1259,895,364,1067,1006,61,21
2021,Stoke-on-Trent 035,E02006974,5053,2901,1647,1254,12,12,1060,775,285,1058,938,120,22
2021,Portsmouth 027,E02006975,2653,351,168,183,57,57,1330,920,410,902,842,60,13
2021,Portsmouth 028,E02006976,2288,321,163,158,49,49,1551,935,616,352,321,31,15
2021,Chelmsford 022,E02006978,3356,1502,669,833,69,69,380,46,334,1403,1308,95,2
2021,Chelmsford 023,E02006979,3348,1223,537,686,170,170,424,50,374,1530,1438,92,1
2021,Rochford 011,E02006980,2985,2711,1483,1228,9,9,68,12,56,197,156,41,0
2021,Rochford 012,E02006981,3289,2723,1511,1212,16,16,209,25,184,341,296,45,0
2021,South Staffordshire 015,E02006982,5337,3954,2282,1672,41,41,638,55,583,702,629,73,2
2021,Manchester 061,E02006983,3229,912,248,664,25,25,1231,660,571,1052,1002,50,9
2021,Manchester 062,E02006984,2967,814,189,625,16,16,599,191,408,1535,1465,70,3
2021,Manchester 063,E02006985,2512,891,385,506,13,13,539,93,446,1063,960,103,6
2021,Manchester 064,E02006986,2319,986,379,607,19,19,445,136,309,861,807,54,8
2021,Croydon 046,E02006987,3877,813,194,619,158,158,512,146,366,2390,2278,112,4
2021,Croydon 047,E02006988,3307,1211,453,758,22,22,501,220,281,1565,1494,71,8
2021,Plymouth 033,E02006989,2682,846,407,439,10,10,602,137,465,1224,1159,65,0
2021,Plymouth 034,E02006990,3826,1172,717,455,46,46,1113,335,778,1492,1402,90,3
2021,Greenwich 039,E02006991,3233,815,161,654,271,271,474,56,418,1671,1614,57,2
2021,Greenwich 040,E02006992,3769,1497,306,1191,147,147,1180,546,634,942,892,50,3
2021,Greenwich 041,E02006993,3627,1030,250,780,243,243,925,268,657,1427,1354,73,2
2021,Greenwich 042,E02006994,3284,669,196,473,45,45,1369,1075,294,1188,1148,40,13
2021,Newham 038,E02006995,3237,433,75,358,215,215,845,98,747,1740,1689,51,4
2021,Newham 039,E02006996,3158,831,252,579,219,219,758,414,344,1347,1264,83,3
2021,Newham 040,E02006997,3228,600,145,455,199,199,861,348,513,1560,1492,68,8
2021,Newham 041,E02006998,2668,561,183,378,56,56,1035,740,295,1003,957,46,13
2021,Newham 042,E02006999,5047,1221,245,976,212,212,1082,193,889,2530,2434,96,2
2021,Oldham 036,E02007000,2197,1001,595,406,13,13,639,197,442,496,420,76,48
2021,Oldham 037,E02007001,2220,1488,805,683,4,4,207,38,169,514,436,78,7
2021,Rotherham 034,E02007002,5047,3804,2090,1714,33,33,638,525,113,559,457,102,13
2021,Pendle 014,E02007003,4806,2819,1507,1312,9,9,953,365,588,1018,914,104,7
2021,Thurrock 021,E02007004,2649,1264,311,953,53,53,449,353,96,878,830,48,5
2021,Thurrock 022,E02007005,3115,1693,361,1332,89,89,447,272,175,886,830,56,0
2021,Dorset 031,E02007006,3039,1648,1156,492,84,84,643,40,603,664,585,79,0
2021,Dorset 032,E02007007,2996,1811,1182,629,69,69,585,34,551,531,465,66,0
2021,Lewisham 040,E02007008,2659,580,142,438,146,146,629,112,517,1303,1238,65,1
2021,Lewisham 041,E02007009,3987,1192,372,820,83,83,1395,714,681,1310,1215,95,7
2021,Bedford 021,E02007010,3464,2441,1024,1417,114,114,528,67,461,381,332,49,0
2021,Bedford 022,E02007011,2771,1895,535,1360,190,190,426,54,372,256,230,26,4
2021,Milton Keynes 033,E02007012,3000,1512,448,1064,309,309,467,46,421,712,682,30,0
2021,Milton Keynes 034,E02007013,3491,1865,215,1650,408,408,503,56,447,715,682,33,0
2021,Milton Keynes 035,E02007014,2822,1296,484,812,344,344,356,39,317,826,794,32,0
2021,Milton Keynes 036,E02007015,3738,2165,540,1625,489,489,452,103,349,632,590,42,0
2021,Milton Keynes 037,E02007016,3246,2095,675,1420,350,350,350,73,277,450,419,31,1
2021,Redbridge 037,E02007017,2759,1862,763,1099,37,37,260,84,176,596,535,61,4
2021,Redbridge 038,E02007018,2530,1132,430,702,48,48,442,179,263,901,837,64,7
2021,Redbridge 039,E02007019,2408,549,255,294,31,31,239,127,112,1581,1518,63,8
2021,Redbridge 040,E02007020,2723,1318,730,588,11,11,260,171,89,1128,1016,112,6
2021,Oxford 020,E02007021,2674,1311,667,644,20,20,486,250,236,853,805,48,4
2021,County Durham 067,E02007022,5607,3799,2559,1240,27,27,712,106,606,1069,885,184,0
2021,Wiltshire 063,E02007023,3112,2085,926,1159,33,33,620,74,546,374,316,58,0
2021,Wiltshire 064,E02007024,3132,1972,962,1010,12,12,389,42,347,759,688,71,0
2021,Wiltshire 065,E02007025,3144,1524,633,891,73,73,722,115,607,824,353,471,1
2021,Wiltshire 066,E02007026,2690,634,213,421,29,29,499,100,399,1528,465,1063,0
2021,East Devon 021,E02007027,4337,3009,1395,1614,111,111,599,229,370,613,496,117,5
2021,East Devon 022,E02007028,2271,1353,192,1161,253,253,379,40,339,286,232,54,0
2021,Derbyshire Dales 011,E02007029,5032,3576,2513,1063,39,39,724,170,554,689,539,150,4
2021,Cheshire East 052,E02007030,2793,2162,973,1189,95,95,190,35,155,346,273,73,0
2021,Cheshire East 053,E02007031,3369,2767,1307,1460,29,29,98,16,82,474,414,60,1
2021,North Norfolk 015,E02007032,3250,2164,1493,671,22,22,604,92,512,458,406,52,2
2021,North Norfolk 016,E02007033,2888,1930,1147,783,19,19,399,69,330,539,460,79,1
2021,Tewkesbury 010,E02007034,3437,2335,972,1363,227,227,348,33,315,527,482,45,0
2021,Tewkesbury 011,E02007035,3525,2564,1626,938,63,63,500,60,440,396,331,65,2
2021,Birmingham 141,E02007038,5266,2754,1312,1442,44,44,1546,1187,359,894,797,97,28
2021,Birmingham 142,E02007039,2171,1211,712,499,9,9,301,126,175,646,570,76,4
2021,Birmingham 143,E02007040,2078,1116,519,597,6,6,131,45,86,822,743,79,3
2021,Craven 009,E02007041,4580,3454,2406,1048,40,40,282,43,239,804,614,190,0
2021,Hambleton 012,E02007042,3216,2155,1364,791,21,21,557,67,490,483,425,58,0
2021,Hambleton 013,E02007043,2936,1408,784,624,28,28,884,93,791,615,547,68,1
2021,Ryedale 009,E02007044,3468,1812,848,964,70,70,943,110,833,640,564,76,3
2021,Ryedale 010,E02007045,3057,2251,1452,799,12,12,268,35,233,526,455,71,0
2021,Ashford 015,E02007046,2925,1740,959,781,26,26,638,376,262,517,457,60,4
2021,Ashford 016,E02007047,3364,2247,735,1512,68,68,281,109,172,768,698,70,0
2021,Rugby 013,E02007048,3027,2315,1286,1029,13,13,241,198,43,456,266,190,2
2021,Rugby 014,E02007049,3048,2234,572,1662,121,121,257,55,202,436,394,42,0
2021,Telford and Wrekin 024,E02007050,3248,2070,605,1465,56,56,526,201,325,596,555,41,0
2021,Telford and Wrekin 025,E02007051,3266,2267,614,1653,89,89,511,79,432,398,369,29,1
2021,Norwich 016,E02007052,3699,868,408,460,8,8,1839,1373,466,966,883,83,18
2021,Norwich 017,E02007053,2900,871,551,320,9,9,877,414,463,1137,1072,65,6
2021,South Norfolk 016,E02007054,3545,2512,842,1670,57,57,418,62,356,555,494,61,3
2021,South Norfolk 017,E02007055,3437,2480,1524,956,53,53,518,74,444,386,321,65,0
2021,Colchester 023,E02007056,3387,2389,654,1735,59,59,377,104,273,562,524,38,0
2021,Colchester 024,E02007057,3077,1593,586,1007,26,26,354,61,293,1102,1042,60,2
2021,Darlington 016,E02007058,5992,2635,1391,1244,11,11,720,253,467,2624,2452,172,2
2021,Hartlepool 015,E02007059,4943,2876,1614,1262,17,17,640,156,484,1404,1291,113,6
2021,Stockton-on-Tees 025,E02007060,2861,897,329,568,28,28,1275,658,617,655,539,116,6
2021,Stockton-on-Tees 026,E02007061,3195,1553,530,1023,38,38,592,283,309,1003,913,90,9
2021,Stockton-on-Tees 027,E02007062,2810,2225,515,1710,2,2,49,18,31,533,487,46,1
2021,Stockton-on-Tees 028,E02007063,3183,2833,968,1865,7,7,22,13,9,321,291,30,0
2021,South Gloucestershire 033,E02007064,3336,2252,1132,1120,14,14,576,134,442,490,433,57,4
2021,South Gloucestershire 034,E02007065,3192,1838,556,1282,129,129,666,83,583,554,515,39,5
2021,South Gloucestershire 035,E02007066,2642,1183,392,791,188,188,408,50,358,863,802,61,0
2021,South Gloucestershire 036,E02007067,2654,2026,925,1101,18,18,199,28,171,410,373,37,1
2021,Slough 015,E02007068,2345,708,268,440,42,42,440,169,271,1150,1093,57,5
2021,Slough 016,E02007069,2297,1087,591,496,33,33,266,102,164,906,857,49,5
2021,North Northamptonshire 020,E02007070,2576,1946,905,1041,52,52,249,160,89,327,292,35,2
2021,North Northamptonshire 023,E02007071,4249,2915,1269,1646,162,162,614,255,359,551,496,55,7
2021,West Northamptonshire 035,E02007072,2909,1648,359,1289,196,196,520,56,464,542,488,54,3
2021,West Northamptonshire 039,E02007073,3002,2266,912,1354,102,102,263,16,247,371,339,32,0
2021,Southampton 033,E02007074,3015,459,151,308,69,69,1201,801,400,1277,1234,43,9
2021,Southampton 034,E02007075,3051,1019,353,666,50,50,224,87,137,1758,1693,65,0
2021,Test Valley 016,E02007076,2990,1750,383,1367,220,220,688,84,604,332,256,76,0
2021,Test Valley 017,E02007077,2852,1679,391,1288,235,235,642,111,531,294,235,59,2
2021,Test Valley 018,E02007078,2459,1216,683,533,20,20,714,200,514,505,428,77,4
2021,Kingston upon Hull 034,E02007079,3223,1625,538,1087,17,17,1156,231,925,422,380,42,3
2021,Kingston upon Hull 035,E02007080,3298,2666,458,2208,3,3,33,12,21,596,542,54,0
2021,North East Lincolnshire 024,E02007081,4671,3253,1830,1423,13,13,155,29,126,1249,1144,105,1
2021,Nottingham 041,E02007082,4722,3034,1662,1372,14,14,730,500,230,936,829,107,8
2021,Wandsworth 038,E02007083,4105,980,462,518,329,329,492,167,325,2302,2146,156,2
2021,Wandsworth 039,E02007084,4134,924,383,541,91,91,1694,1342,352,1414,1339,75,11
2021,South Cambridgeshire 022,E02007085,4988,3598,2136,1462,89,89,531,293,238,764,648,116,6
2021,Cambridge 015,E02007086,4271,1775,748,1027,294,294,1110,369,741,1089,1009,80,3
2021,Cambridge 014,E02007087,2431,842,547,295,54,54,543,144,399,991,883,108,1
2021,North Hertfordshire 016,E02007088,3160,2247,1296,951,30,30,414,117,297,466,368,98,3
2021,North Hertfordshire 017,E02007089,2817,1976,644,1332,66,66,334,64,270,441,411,30,0
2021,St Albans 021,E02007090,2367,1644,805,839,14,14,447,177,270,260,207,53,2
2021,Stevenage 013,E02007091,2688,2066,1001,1065,10,10,243,182,61,368,344,24,1
2021,Welwyn Hatfield 017,E02007092,2298,1343,746,597,7,7,549,477,72,393,354,39,6
2021,East Hertfordshire 019,E02007093,3296,2404,1317,1087,41,41,491,63,428,360,290,70,0
2021,Gateshead 029,E02007094,3275,1982,1175,807,11,11,603,533,70,678,593,85,1
2021,Newcastle upon Tyne 032,E02007095,4136,3016,813,2203,30,30,652,447,205,436,385,51,2
2021,Newcastle upon Tyne 033,E02007096,2449,1923,1048,875,3,3,69,54,15,452,394,58,2
2021,Newcastle upon Tyne 034,E02007097,2747,740,346,394,7,7,743,587,156,1247,1170,77,10
2021,Newcastle upon Tyne 035,E02007098,2995,1197,619,578,5,5,1109,917,192,670,606,64,14
2021,Newcastle upon Tyne 036,E02007099,3274,460,250,210,10,10,955,203,752,1845,1759,86,4
2021,Newcastle upon Tyne 037,E02007100,2026,358,176,182,7,7,868,640,228,786,714,72,7
2021,Newcastle upon Tyne 038,E02007101,3150,954,467,487,8,8,809,579,230,1363,1225,138,16
2021,Newcastle upon Tyne 039,E02007102,2500,413,233,180,2,2,1376,819,557,699,639,60,10
2021,Newcastle upon Tyne 040,E02007103,3043,639,313,326,7,7,1715,927,788,671,616,55,11
2021,Newcastle upon Tyne 041,E02007104,2170,341,136,205,4,4,1514,1159,355,289,251,38,22
2021,Northumberland 041,E02007105,5751,3868,2086,1782,45,45,936,476,460,898,738,160,4
2021,Northumberland 042,E02007106,6201,4806,2299,2507,40,40,749,550,199,599,513,86,7
2021,Northumberland 043,E02007107,3975,3019,2006,1013,37,37,355,99,256,563,450,113,1
2021,Hackney 030,E02007108,2802,741,252,489,49,49,546,196,350,1461,1392,69,5
2021,Hackney 031,E02007109,3303,924,379,545,65,65,1268,555,713,1029,974,55,17
2021,Hackney 032,E02007110,3361,577,253,324,85,85,1438,1022,416,1254,1176,78,7
2021,Hackney 033,E02007111,2818,456,166,290,66,66,633,526,107,1649,1577,72,14
2021,Tower Hamlets 034,E02007112,2918,614,206,408,62,62,365,77,288,1875,1791,84,2
2021,Tower Hamlets 035,E02007113,3269,791,234,557,90,90,807,203,604,1580,1473,107,1
2021,Tower Hamlets 036,E02007114,3033,693,250,443,93,93,792,137,655,1454,1389,65,1
2021,Camden 029,E02007115,4469,742,460,282,23,23,2252,1364,888,1430,1289,141,22
2021,Oxford 019,E02007116,2752,1044,512,532,94,94,510,270,240,1099,1038,61,5
2021,Isle of Anglesey 001,W02000001,3786,2575,1725,850,4,4,619,503,116,580,444,136,8
2021,Isle of Anglesey 002,W02000002,2924,2293,1664,629,6,6,205,183,22,417,324,93,3
2021,Isle of Anglesey 003,W02000003,4831,2461,1385,1076,15,15,1375,1024,351,951,833,118,29
2021,Isle of Anglesey 004,W02000004,3320,2594,1746,848,10,10,331,264,67,379,274,105,6
2021,Isle of Anglesey 005,W02000005,3794,2843,2044,799,14,14,384,318,66,542,425,117,11
2021,Isle of Anglesey 006,W02000006,3039,1844,1093,751,9,9,797,584,213,373,284,89,16
2021,Isle of Anglesey 007,W02000007,2887,1841,1152,689,10,10,412,321,91,613,413,200,11
2021,Isle of Anglesey 008,W02000008,2768,2047,1367,680,6,6,285,243,42,423,347,76,7
2021,Isle of Anglesey 009,W02000009,3475,2522,1580,942,11,11,414,345,69,519,388,131,9
2021,Gwynedd 001,W02000010,2690,819,517,302,14,14,678,266,412,1173,1081,92,6
2021,Gwynedd 002,W02000011,3389,1825,974,851,6,6,986,436,550,565,489,76,7
2021,Gwynedd 003,W02000012,3560,2423,1388,1035,6,6,525,225,300,595,468,127,11
2021,Gwynedd 004,W02000013,2760,2086,1205,881,8,8,242,88,154,419,343,76,5
2021,Gwynedd 005,W02000014,2920,2080,1229,851,4,4,438,211,227,385,298,87,13
2021,Gwynedd 006,W02000015,3678,2133,1242,891,12,12,1068,564,504,453,367,86,12
2021,Gwynedd 007,W02000016,2732,1948,1181,767,8,8,391,172,219,377,307,70,8
2021,Gwynedd 008,W02000017,3287,2353,1497,856,11,11,528,232,296,387,299,88,8
2021,Gwynedd 009,W02000018,2799,1910,1333,577,7,7,457,175,282,422,336,86,3
2021,Gwynedd 010,W02000019,3062,2132,1558,574,3,3,444,126,318,479,343,136,4
2021,Gwynedd 011,W02000020,2841,2035,1482,553,12,12,347,120,227,443,317,126,4
2021,Gwynedd 012,W02000021,3471,2143,1464,679,11,11,642,266,376,667,511,156,8
2021,Gwynedd 013,W02000022,2672,1990,1468,522,11,11,299,101,198,370,266,104,2
2021,Gwynedd 014,W02000023,2336,1570,1193,377,8,8,297,75,222,459,339,120,2
2021,Gwynedd 015,W02000024,2551,1694,1232,462,8,8,369,140,229,476,349,127,4
2021,Gwynedd 016,W02000025,2880,1853,1349,504,12,12,453,194,259,558,435,123,4
2021,Gwynedd 017,W02000026,3480,2435,1903,532,10,10,393,130,263,638,513,125,4
2021,Conwy 001,W02000027,4227,2168,1507,661,10,10,647,175,472,1397,1274,123,5
2021,Conwy 002,W02000028,2986,1947,1312,635,21,21,682,242,440,331,279,52,5
2021,Conwy 003,W02000029,2740,2292,1541,751,13,13,31,10,21,403,341,62,1
2021,Conwy 004,W02000030,2953,1973,1371,602,10,10,358,112,246,605,509,96,7
2021,Conwy 005,W02000031,3610,2636,1640,996,57,57,254,94,160,663,560,103,0
2021,Conwy 006,W02000032,3875,3077,2002,1075,33,33,274,77,197,490,417,73,1
2021,Conwy 007,W02000033,3140,1631,976,655,7,7,368,68,300,1133,1043,90,1
2021,Conwy 008,W02000034,3346,2350,1320,1030,20,20,465,158,307,508,425,83,3
2021,Conwy 009,W02000035,3776,2549,1447,1102,22,22,638,304,334,564,472,92,3
2021,Conwy 010,W02000036,5373,3769,2513,1256,29,29,606,183,423,967,867,100,2
2021,Conwy 011,W02000037,3179,2230,1250,980,16,16,349,149,200,581,503,78,3
2021,Conwy 012,W02000038,2845,2015,1322,693,15,15,344,94,250,468,388,80,3
2021,Conwy 013,W02000039,3674,2527,1543,984,18,18,503,162,341,626,533,93,0
2021,Conwy 014,W02000040,2788,1991,1346,645,10,10,258,102,156,527,403,124,2
2021,Conwy 015,W02000041,3721,2570,1669,901,9,9,479,120,359,658,512,146,5
2021,Denbighshire 001,W02000042,2716,1940,1250,690,28,28,128,57,71,618,543,75,2
2021,Denbighshire 002,W02000043,2290,1440,848,592,30,30,389,216,173,422,371,51,9
2021,Denbighshire 003,W02000044,2495,1943,1286,657,11,11,57,19,38,482,415,67,2
2021,Denbighshire 004,W02000045,4322,1890,1155,735,23,23,736,227,509,1670,1545,125,3
2021,Denbighshire 006,W02000047,2169,963,454,509,7,7,735,512,223,452,397,55,12
2021,Denbighshire 008,W02000049,2844,2032,1157,875,13,13,309,238,71,484,384,100,6
2021,Denbighshire 009,W02000050,2867,2010,1182,828,15,15,272,191,81,564,477,87,6
2021,Denbighshire 010,W02000051,2359,1646,995,651,2,2,327,201,126,381,318,63,3
2021,Denbighshire 011,W02000052,2244,1139,646,493,18,18,639,403,236,434,390,44,14
2021,Denbighshire 012,W02000053,2708,2093,1241,852,8,8,220,103,117,387,304,83,0
2021,Denbighshire 013,W02000054,2611,2011,1280,731,6,6,245,154,91,348,280,68,1
2021,Denbighshire 014,W02000055,2628,1726,1073,653,5,5,408,221,187,488,416,72,1
2021,Denbighshire 015,W02000056,2208,1587,972,615,10,10,249,190,59,362,285,77,0
2021,Denbighshire 016,W02000057,2888,1916,1267,649,13,13,422,244,178,530,424,106,7
2021,Flintshire 001,W02000058,2337,1682,1042,640,8,8,318,255,63,326,263,63,3
2021,Flintshire 002,W02000059,2751,2026,1181,845,21,21,366,320,46,336,273,63,2
2021,Flintshire 003,W02000060,4639,2725,1519,1206,15,15,1144,797,347,752,672,80,3
2021,Flintshire 004,W02000061,3363,1705,702,1003,13,13,1136,782,354,507,447,60,2
2021,Flintshire 005,W02000062,2480,2042,1082,960,6,6,173,31,142,259,204,55,0
2021,Flintshire 006,W02000063,3528,2867,1769,1098,16,16,279,244,35,366,286,80,0
2021,Flintshire 007,W02000064,2649,1428,705,723,16,16,765,584,181,440,399,41,0
2021,Flintshire 008,W02000065,3015,2379,1209,1170,16,16,151,83,68,468,386,82,1
2021,Flintshire 009,W02000066,4237,2319,1182,1137,16,16,1155,818,337,744,671,73,3
2021,Flintshire 010,W02000067,2726,2356,1209,1147,13,13,166,96,70,191,166,25,0
2021,Flintshire 011,W02000068,2395,1532,858,674,19,19,421,265,156,421,373,48,2
2021,Flintshire 012,W02000069,2724,2208,1232,976,12,12,177,116,61,326,272,54,1
2021,Flintshire 013,W02000070,4480,3710,2039,1671,29,29,216,193,23,522,443,79,3
2021,Flintshire 014,W02000071,3092,2666,1563,1103,7,7,114,72,42,305,251,54,0
2021,Flintshire 015,W02000072,5037,3500,1607,1893,27,27,773,654,119,735,648,87,2
2021,Flintshire 016,W02000073,4566,3088,1779,1309,31,31,847,526,321,599,506,93,1
2021,Flintshire 017,W02000074,4427,3025,1507,1518,15,15,709,525,184,676,578,98,2
2021,Flintshire 018,W02000075,2670,2294,1162,1132,5,5,161,121,40,210,175,35,0
2021,Flintshire 019,W02000076,3201,2464,1478,986,9,9,363,280,83,360,286,74,5
2021,Flintshire 020,W02000077,2590,2003,1120,883,11,11,281,221,60,295,244,51,0
2021,Wrexham 003,W02000080,3309,2189,1071,1118,7,7,739,641,98,367,310,57,7
2021,Wrexham 004,W02000081,2402,1533,718,815,6,6,574,521,53,275,237,38,14
2021,Wrexham 005,W02000082,3294,2051,939,1112,8,8,752,612,140,477,406,71,6
2021,Wrexham 006,W02000083,3705,2394,1119,1275,10,10,725,660,65,569,498,71,7
2021,Wrexham 008,W02000085,4063,2761,1717,1044,10,10,475,333,142,808,721,87,9
2021,Wrexham 010,W02000087,2772,801,409,392,5,5,1713,1637,76,230,188,42,23
2021,Wrexham 011,W02000088,3869,1860,982,878,45,45,583,313,270,1370,1216,154,11
2021,Wrexham 012,W02000089,3930,1563,830,733,20,20,1303,810,493,1028,954,74,16
2021,Wrexham 013,W02000090,2388,1618,916,702,7,7,516,422,94,239,190,49,8
2021,Wrexham 014,W02000091,2676,1955,1104,851,8,8,324,256,68,380,305,75,9
2021,Wrexham 015,W02000092,3000,1606,839,767,15,15,818,673,145,548,484,64,13
2021,Wrexham 016,W02000093,2865,1877,1023,854,6,6,461,343,118,512,429,83,9
2021,Wrexham 017,W02000094,3824,2064,1121,943,6,6,1356,1218,138,378,293,85,20
2021,Wrexham 018,W02000095,2760,2112,1349,763,10,10,203,175,28,431,368,63,4
2021,Wrexham 019,W02000096,2825,1899,1118,781,3,3,556,401,155,362,290,72,5
2021,Powys 001,W02000097,4054,2974,2119,855,9,9,354,227,127,708,546,162,9
2021,Powys 002,W02000098,2735,2139,1369,770,3,3,164,115,49,429,322,107,0
2021,Powys 003,W02000099,3045,1511,958,553,9,9,827,335,492,687,605,82,11
2021,Powys 004,W02000100,2808,1953,1371,582,4,4,408,283,125,436,324,112,7
2021,Powys 005,W02000101,2467,1755,1144,611,12,12,164,143,21,533,435,98,3
2021,Powys 006,W02000102,2683,2024,1354,670,13,13,238,188,50,402,314,88,6
2021,Powys 007,W02000103,2472,1849,1274,575,10,10,213,136,77,398,297,101,2
2021,Powys 008,W02000104,3005,1713,1128,585,6,6,642,342,300,639,556,83,5
2021,Powys 009,W02000105,2147,862,468,394,6,6,969,600,369,305,261,44,5
2021,Powys 010,W02000106,3005,2103,1477,626,4,4,318,205,113,574,468,106,6
2021,Powys 011,W02000107,4515,3245,2443,802,9,9,472,319,153,779,605,174,10
2021,Powys 012,W02000108,3309,2378,1786,592,9,9,337,219,118,579,464,115,6
2021,Powys 013,W02000109,2797,1571,1076,495,5,5,467,230,237,749,680,69,5
2021,Powys 014,W02000110,3148,2256,1601,655,8,8,278,165,113,605,498,107,1
2021,Powys 015,W02000111,3958,2713,1972,741,19,19,463,328,135,757,577,180,6
2021,Powys 017,W02000113,3715,2097,1398,699,4,4,834,466,368,773,592,181,7
2021,Powys 018,W02000114,3076,2308,1612,696,8,8,333,201,132,426,309,117,1
2021,Ceredigion 001,W02000116,3247,2481,1619,862,11,11,229,52,177,526,435,91,0
2021,Ceredigion 002,W02000117,2949,1013,720,293,12,12,384,67,317,1539,1436,103,1
2021,Ceredigion 003,W02000118,2710,1484,908,576,10,10,579,126,453,636,566,70,1
2021,Ceredigion 005,W02000120,3233,2444,1728,716,9,9,201,33,168,578,430,148,1
2021,Ceredigion 007,W02000122,2857,2279,1663,616,9,9,171,36,135,397,295,102,1
2021,Ceredigion 008,W02000123,3336,2354,1712,642,8,8,341,89,252,631,501,130,2
2021,Ceredigion 009,W02000124,4178,2663,1898,765,11,11,750,215,535,751,628,123,3
2021,Ceredigion 010,W02000125,3383,2570,1851,719,10,10,335,79,256,467,350,117,1
2021,Pembrokeshire 001,W02000126,3638,2824,2037,787,11,11,257,118,139,545,410,135,1
2021,Pembrokeshire 002,W02000127,4446,3082,2235,847,12,12,605,327,278,747,581,166,0
2021,Pembrokeshire 003,W02000128,3185,2305,1645,660,13,13,453,290,163,410,279,131,4
2021,Pembrokeshire 004,W02000129,3047,2401,1580,821,11,11,192,102,90,442,318,124,1
2021,Pembrokeshire 005,W02000130,3183,1481,915,566,8,8,855,539,316,837,672,165,2
2021,Pembrokeshire 006,W02000131,3175,2053,1241,812,3,3,592,339,253,525,454,71,2
2021,Pembrokeshire 007,W02000132,3122,2237,1476,761,16,16,303,171,132,566,428,138,0
2021,Pembrokeshire 008,W02000133,3539,2664,1785,879,7,7,371,259,112,495,377,118,2
2021,Pembrokeshire 009,W02000134,3666,2749,1743,1006,8,8,502,343,159,407,324,83,0
2021,Pembrokeshire 010,W02000135,3419,1897,1188,709,5,5,921,537,384,596,507,89,0
2021,Pembrokeshire 011,W02000136,3798,2878,2023,855,12,12,305,171,134,602,478,124,1
2021,Pembrokeshire 012,W02000137,3331,1824,1071,753,6,6,956,792,164,540,442,98,5
2021,Pembrokeshire 013,W02000138,4430,2502,1458,1044,7,7,1005,564,441,907,817,90,9
2021,Pembrokeshire 014,W02000139,3446,2730,1877,853,9,9,324,209,115,382,271,111,1
2021,Pembrokeshire 015,W02000140,3290,1800,1121,679,6,6,908,639,269,572,472,100,4
2021,Pembrokeshire 016,W02000141,2771,1772,1250,522,7,7,449,292,157,540,449,91,3
2021,Carmarthenshire 001,W02000142,2415,1754,1223,531,8,8,297,243,54,354,267,87,2
2021,Carmarthenshire 002,W02000143,2444,1871,1384,487,2,2,227,158,69,343,256,87,1
2021,Carmarthenshire 003,W02000144,3318,2501,1760,741,11,11,304,237,67,498,402,96,4
2021,Carmarthenshire 004,W02000145,3118,2368,1639,729,8,8,260,170,90,481,369,112,1
2021,Carmarthenshire 005,W02000146,2795,2324,1567,757,14,14,133,95,38,322,220,102,2
2021,Carmarthenshire 006,W02000147,3495,2446,1398,1048,15,15,427,184,243,606,517,89,1
2021,Carmarthenshire 007,W02000148,2348,1336,821,515,7,7,592,382,210,411,360,51,2
2021,Carmarthenshire 008,W02000149,3144,1885,1263,622,14,14,506,304,202,732,651,81,7
2021,Carmarthenshire 010,W02000151,3242,2186,1341,845,6,6,589,467,122,450,358,92,11
2021,Carmarthenshire 011,W02000152,3676,2660,1614,1046,9,9,598,423,175,403,317,86,6
2021,Carmarthenshire 012,W02000153,3734,2985,1880,1105,10,10,344,315,29,389,296,93,6
2021,Carmarthenshire 013,W02000154,3451,2317,1402,915,4,4,613,375,238,512,436,76,5
2021,Carmarthenshire 015,W02000156,3548,2680,1524,1156,5,5,382,320,62,480,405,75,1
2021,Carmarthenshire 016,W02000157,4308,3327,1846,1481,13,13,545,487,58,416,322,94,7
2021,Carmarthenshire 017,W02000158,2549,2008,1098,910,5,5,223,188,35,311,254,57,2
2021,Carmarthenshire 018,W02000159,2665,1858,1173,685,6,6,442,353,89,353,278,75,6
2021,Carmarthenshire 019,W02000160,3285,2637,1647,990,4,4,363,266,97,278,226,52,3
2021,Carmarthenshire 020,W02000161,2205,1357,787,570,5,5,503,412,91,333,290,43,7
2021,Carmarthenshire 021,W02000162,3715,2712,1787,925,9,9,463,367,96,524,426,98,7
2021,Carmarthenshire 022,W02000163,2338,1487,875,612,2,2,378,272,106,469,407,62,2
2021,Carmarthenshire 023,W02000164,3309,2426,1419,1007,7,7,333,257,76,541,463,78,2
2021,Carmarthenshire 024,W02000165,2779,1717,986,731,5,5,563,392,171,488,419,69,6
2021,Carmarthenshire 025,W02000166,3852,2479,1259,1220,12,12,910,775,135,441,359,82,10
2021,Carmarthenshire 026,W02000167,4711,2241,1298,943,12,12,1173,750,423,1267,1141,126,18
2021,Swansea 001,W02000168,2833,1942,1002,940,2,2,427,253,174,458,396,62,4
2021,Swansea 002,W02000169,4020,2738,1628,1110,7,7,695,500,195,571,479,92,9
2021,Swansea 003,W02000170,3808,2748,1632,1116,12,12,568,479,89,466,378,88,14
2021,Swansea 004,W02000171,3536,2820,1353,1467,17,17,269,120,149,428,360,68,2
2021,Swansea 005,W02000172,4499,2945,1486,1459,8,8,849,430,419,690,577,113,7
2021,Swansea 006,W02000173,3252,2363,1035,1328,3,3,427,225,202,458,393,65,1
2021,Swansea 007,W02000174,4218,3342,1821,1521,9,9,421,308,113,434,359,75,12
2021,Swansea 008,W02000175,3423,1989,1083,906,12,12,633,277,356,785,697,88,4
2021,Swansea 009,W02000176,3989,2548,1525,1023,7,7,1015,639,376,403,331,72,16
2021,Swansea 010,W02000177,2988,2024,1018,1006,8,8,511,253,258,439,379,60,6
2021,Swansea 011,W02000178,3668,1101,518,583,5,5,2128,1543,585,373,324,49,61
2021,Swansea 012,W02000179,2791,2183,1246,937,5,5,202,144,58,397,337,60,4
2021,Swansea 013,W02000180,3379,1777,921,856,7,7,1045,955,90,528,464,64,22
2021,Swansea 014,W02000181,3329,1777,903,874,8,8,950,694,256,577,508,69,17
2021,Swansea 015,W02000182,3415,2213,1219,994,9,9,427,198,229,765,662,103,1
2021,Swansea 016,W02000183,4498,2218,1218,1000,11,11,1029,421,608,1230,1084,146,10
2021,Swansea 017,W02000184,3120,1970,1049,921,4,4,723,466,257,404,327,77,19
2021,Swansea 018,W02000185,2201,1798,1106,692,5,5,184,151,33,212,160,52,2
2021,Swansea 019,W02000186,3777,1129,622,507,7,7,2209,2071,138,399,334,65,33
2021,Swansea 021,W02000188,3822,1916,1089,827,55,55,747,352,395,1094,963,131,10
2021,Swansea 022,W02000189,3851,2398,1316,1082,5,5,981,565,416,457,383,74,10
2021,Swansea 024,W02000191,3665,2058,1158,900,15,15,295,72,223,1291,1197,94,6
2021,Swansea 025,W02000192,4881,1190,705,485,8,8,1623,355,1268,2045,1885,160,15
2021,Swansea 026,W02000193,3538,1197,740,457,12,12,482,38,444,1843,1735,108,4
2021,Swansea 027,W02000194,2421,1934,1233,701,11,11,85,43,42,382,339,43,9
2021,Swansea 028,W02000195,2634,2315,1543,772,13,13,87,40,47,219,158,61,0
2021,Swansea 029,W02000196,3008,2097,1372,725,10,10,581,522,59,314,244,70,6
2021,Swansea 030,W02000197,2585,2245,1599,646,12,12,84,50,34,243,164,79,1
2021,Swansea 031,W02000198,3387,2729,1817,912,19,19,99,21,78,538,439,99,2
2021,Neath Port Talbot 002,W02000200,2250,1556,990,566,6,6,416,164,252,265,200,65,7
2021,Neath Port Talbot 003,W02000201,2350,1603,955,648,5,5,396,138,258,345,280,65,1
2021,Neath Port Talbot 004,W02000202,5329,3844,2134,1710,21,21,875,331,544,581,448,133,8
2021,Neath Port Talbot 006,W02000204,2959,2434,1517,917,6,6,200,65,135,316,233,83,3
2021,Neath Port Talbot 007,W02000205,2612,1793,1106,687,5,5,561,143,418,250,185,65,3
2021,Neath Port Talbot 008,W02000206,3334,1743,1118,625,6,6,865,237,628,714,628,86,6
2021,Neath Port Talbot 009,W02000207,2284,1960,1177,783,3,3,141,54,87,180,129,51,0
2021,Neath Port Talbot 010,W02000208,4551,3225,1481,1744,8,8,645,231,414,670,561,109,3
2021,Neath Port Talbot 012,W02000210,2685,1527,835,692,1,1,816,373,443,331,272,59,10
2021,Neath Port Talbot 013,W02000211,3655,2016,1112,904,8,8,911,384,527,702,625,77,18
2021,Neath Port Talbot 014,W02000212,3492,2393,1351,1042,2,2,756,327,429,337,249,88,4
2021,Neath Port Talbot 015,W02000213,2955,2393,1337,1056,4,4,233,87,146,323,236,87,2
2021,Neath Port Talbot 016,W02000214,4105,2239,1348,891,0,0,1377,667,710,474,362,112,15
2021,Neath Port Talbot 017,W02000215,4396,2295,1343,952,6,6,1125,405,720,953,815,138,17
2021,Neath Port Talbot 018,W02000216,3202,2198,1215,983,5,5,354,80,274,644,546,98,1
2021,Neath Port Talbot 019,W02000217,2766,1931,1034,897,3,3,437,116,321,392,310,82,3
2021,Bridgend 001,W02000218,2889,1862,1145,717,5,5,386,139,247,631,559,72,5
2021,Bridgend 002,W02000219,3255,2198,1289,909,8,8,491,139,352,551,474,77,7
2021,Bridgend 003,W02000220,3463,2339,1265,1074,8,8,382,97,285,729,643,86,5
2021,Bridgend 004,W02000221,3248,2126,1175,951,8,8,530,131,399,580,507,73,4
2021,Bridgend 005,W02000222,2599,1988,1247,741,4,4,277,118,159,329,265,64,1
2021,Bridgend 006,W02000223,2641,1847,902,945,9,9,433,104,329,349,291,58,3
2021,Bridgend 007,W02000224,2788,1874,915,959,4,4,544,149,395,362,289,73,4
2021,Bridgend 008,W02000225,3797,2452,1293,1159,7,7,798,237,561,537,431,106,3
2021,Bridgend 009,W02000226,4282,3298,1794,1504,7,7,464,126,338,513,437,76,0
2021,Bridgend 010,W02000227,3175,1959,1047,912,5,5,767,266,501,437,353,84,7
2021,Bridgend 011,W02000228,4404,3587,1305,2282,7,7,303,34,269,506,436,70,1
2021,Bridgend 012,W02000229,2720,1827,1003,824,5,5,569,102,467,317,265,52,2
2021,Bridgend 013,W02000230,2345,2033,1162,871,6,6,63,16,47,243,190,53,0
2021,Bridgend 014,W02000231,3907,2156,1164,992,8,8,933,188,745,802,716,86,8
2021,Bridgend 015,W02000232,2460,1881,939,942,3,3,149,11,138,427,384,43,0
2021,Bridgend 016,W02000233,2664,1566,845,721,5,5,637,42,595,456,399,57,0
2021,Bridgend 017,W02000234,4302,3257,1514,1743,9,9,523,89,434,510,421,89,3
2021,Bridgend 018,W02000235,4224,3369,2201,1168,22,22,141,34,107,690,588,102,2
2021,Bridgend 019,W02000236,3201,2340,1464,876,6,6,289,67,222,561,479,82,5
2021,Vale of Glamorgan 001,W02000237,2576,2217,1283,934,8,8,141,44,97,210,156,54,0
2021,Vale of Glamorgan 002,W02000238,2888,2374,1531,843,9,9,160,78,82,345,275,70,0
2021,Vale of Glamorgan 003,W02000239,3359,2861,1591,1270,7,7,195,62,133,296,214,82,0
2021,Vale of Glamorgan 004,W02000240,3728,2771,1390,1381,11,11,499,285,214,445,377,68,2
2021,Vale of Glamorgan 005,W02000241,4758,3325,1857,1468,11,11,277,111,166,1145,1012,133,0
2021,Vale of Glamorgan 006,W02000242,3603,2881,1661,1220,7,7,404,175,229,302,216,86,9
2021,Vale of Glamorgan 007,W02000243,3916,2196,1030,1166,0,0,1288,928,360,426,357,69,6
2021,Vale of Glamorgan 008,W02000244,4307,3375,2006,1369,5,5,405,227,178,519,444,75,3
2021,Vale of Glamorgan 009,W02000245,3544,2323,1032,1291,12,12,606,251,355,599,509,90,4
2021,Vale of Glamorgan 010,W02000246,2345,2130,1318,812,9,9,58,48,10,148,114,34,0
2021,Vale of Glamorgan 011,W02000247,3792,2880,1777,1103,15,15,378,278,100,517,408,109,2
2021,Vale of Glamorgan 012,W02000248,4712,2798,1254,1544,12,12,597,199,398,1305,1177,128,0
2021,Vale of Glamorgan 013,W02000249,3871,2286,1097,1189,5,5,761,540,221,817,731,86,2
2021,Vale of Glamorgan 014,W02000250,4846,3428,1713,1715,11,11,409,204,205,997,674,323,1
2021,Vale of Glamorgan 015,W02000251,5209,3441,1514,1927,13,13,847,231,616,906,810,96,2
2021,Rhondda Cynon Taf 001,W02000252,3921,2477,1517,960,4,4,940,508,432,490,403,87,10
2021,Rhondda Cynon Taf 002,W02000253,3051,2054,1171,883,1,1,333,128,205,662,546,116,1
2021,Rhondda Cynon Taf 003,W02000254,3521,2484,1433,1051,4,4,385,160,225,644,572,72,4
2021,Rhondda Cynon Taf 004,W02000255,3061,2129,1188,941,5,5,585,239,346,337,282,55,5
2021,Rhondda Cynon Taf 005,W02000256,4493,2890,1645,1245,10,10,642,177,465,946,811,135,5
2021,Rhondda Cynon Taf 006,W02000257,3302,2191,1271,920,1,1,510,220,290,595,520,75,5
2021,Rhondda Cynon Taf 007,W02000258,2627,1713,1160,553,8,8,379,114,265,525,453,72,2
2021,Rhondda Cynon Taf 008,W02000259,2429,1432,884,548,8,8,394,137,257,594,522,72,1
2021,Rhondda Cynon Taf 009,W02000260,2599,1606,1113,493,4,4,456,201,255,530,442,88,3
2021,Rhondda Cynon Taf 010,W02000261,3388,2457,1602,855,7,7,278,51,227,642,554,88,4
2021,Rhondda Cynon Taf 011,W02000262,2366,1631,965,666,0,0,228,47,181,506,440,66,1
2021,Rhondda Cynon Taf 012,W02000263,2749,1828,1028,800,0,0,394,206,188,525,459,66,2
2021,Rhondda Cynon Taf 013,W02000264,2578,1522,978,544,4,4,312,128,184,737,671,66,3
2021,Rhondda Cynon Taf 014,W02000265,4013,2593,1546,1047,10,10,552,224,328,855,728,127,3
2021,Rhondda Cynon Taf 015,W02000266,3256,2159,1199,960,3,3,599,319,280,490,421,69,5
2021,Rhondda Cynon Taf 016,W02000267,2784,1866,1110,756,5,5,158,47,111,753,652,101,2
2021,Rhondda Cynon Taf 017,W02000268,4074,2851,1689,1162,6,6,322,115,207,892,782,110,3
2021,Rhondda Cynon Taf 018,W02000269,3564,2387,1412,975,4,4,453,210,243,713,590,123,7
2021,Rhondda Cynon Taf 019,W02000270,2958,2150,1186,964,8,8,241,86,155,556,475,81,3
2021,Rhondda Cynon Taf 020,W02000271,2477,1515,899,616,5,5,547,326,221,406,359,47,4
2021,Rhondda Cynon Taf 021,W02000272,4431,3151,1832,1319,8,8,360,86,274,909,778,131,3
2021,Rhondda Cynon Taf 022,W02000273,4039,1797,949,848,9,9,1080,313,767,1145,1044,101,8
2021,Rhondda Cynon Taf 023,W02000274,4160,2948,1481,1467,15,15,683,388,295,503,413,90,11
2021,Rhondda Cynon Taf 024,W02000275,2657,1808,998,810,3,3,483,232,251,362,293,69,1
2021,Rhondda Cynon Taf 025,W02000276,2825,2218,1246,972,5,5,370,172,198,227,187,40,5
2021,Rhondda Cynon Taf 026,W02000277,3188,2197,1127,1070,7,7,580,225,355,397,326,71,7
2021,Rhondda Cynon Taf 027,W02000278,3637,3173,1533,1640,6,6,65,22,43,393,325,68,0
2021,Rhondda Cynon Taf 028,W02000279,3274,2399,1211,1188,4,4,433,196,237,437,386,51,1
2021,Rhondda Cynon Taf 029,W02000280,3882,2906,1280,1626,5,5,464,144,320,503,430,73,4
2021,Rhondda Cynon Taf 030,W02000281,3266,2426,1309,1117,3,3,467,160,307,366,294,72,4
2021,Rhondda Cynon Taf 031,W02000282,4758,3669,1725,1944,10,10,482,161,321,596,510,86,1
2021,Merthyr Tydfil 002,W02000284,4233,2502,1401,1101,4,4,962,286,676,755,633,122,10
2021,Merthyr Tydfil 003,W02000285,3523,2708,1543,1165,3,3,348,88,260,462,390,72,2
2021,Merthyr Tydfil 004,W02000286,3260,1449,833,616,2,2,1143,364,779,657,564,93,9
2021,Merthyr Tydfil 005,W02000287,3653,2657,1451,1206,8,8,392,121,271,593,500,93,3
2021,Merthyr Tydfil 006,W02000288,3603,2332,1403,929,6,6,662,159,503,601,497,104,2
2021,Merthyr Tydfil 007,W02000289,3706,2703,1434,1269,6,6,469,134,335,528,442,86,0
2021,Caerphilly 001,W02000290,3883,2198,1323,875,10,10,1182,1021,161,492,411,81,1
2021,Caerphilly 002,W02000291,3111,1957,1167,790,3,3,573,459,114,576,498,78,2
2021,Caerphilly 003,W02000292,2519,1518,768,750,5,5,628,447,181,367,310,57,1
2021,Caerphilly 004,W02000293,2670,1624,940,684,3,3,524,458,66,519,459,60,0
2021,Caerphilly 005,W02000294,2416,1759,1019,740,12,12,386,250,136,259,217,42,0
2021,Caerphilly 006,W02000295,3931,2925,1527,1398,23,23,559,338,221,423,351,72,1
2021,Caerphilly 007,W02000296,3237,1985,1111,874,10,10,856,557,299,380,321,59,6
2021,Caerphilly 008,W02000297,3247,2204,1155,1049,5,5,594,428,166,437,357,80,7
2021,Caerphilly 009,W02000298,3021,2232,1135,1097,7,7,411,276,135,368,318,50,3
2021,Caerphilly 010,W02000299,2722,1808,1031,777,3,3,502,400,102,405,349,56,4
2021,Caerphilly 011,W02000300,3596,2480,1397,1083,6,6,684,547,137,425,377,48,1
2021,Caerphilly 012,W02000301,3263,2313,1067,1246,3,3,602,373,229,344,280,64,1
2021,Caerphilly 013,W02000302,4318,3192,1704,1488,5,5,528,286,242,590,497,93,3
2021,Caerphilly 014,W02000303,3121,2187,1093,1094,14,14,434,272,162,483,399,84,3
2021,Caerphilly 015,W02000304,2423,1587,830,757,11,11,431,244,187,394,332,62,0
2021,Caerphilly 016,W02000305,2738,1874,1022,852,15,15,563,446,117,286,251,35,0
2021,Caerphilly 017,W02000306,2363,1558,889,669,6,6,384,281,103,414,352,62,1
2021,Caerphilly 018,W02000307,2775,1719,834,885,6,6,519,261,258,529,447,82,2
2021,Caerphilly 019,W02000308,3786,2513,1287,1226,12,12,776,534,242,482,426,56,3
2021,Caerphilly 020,W02000309,2904,2038,1082,956,6,6,531,375,156,328,267,61,1
2021,Caerphilly 021,W02000310,2245,1535,851,684,3,3,497,452,45,210,170,40,0
2021,Caerphilly 022,W02000311,4358,2616,1377,1239,40,40,1142,785,357,556,477,79,4
2021,Caerphilly 023,W02000312,3136,2193,1180,1013,8,8,622,419,203,310,242,68,3
2021,Caerphilly 024,W02000313,4464,3487,1658,1829,8,8,391,152,239,578,491,87,0
2021,Blaenau Gwent 001,W02000314,2931,1813,1098,715,4,4,851,389,462,258,208,50,5
2021,Blaenau Gwent 002,W02000315,2423,1400,790,610,5,5,599,183,416,416,374,42,3
2021,Blaenau Gwent 003,W02000316,2937,1790,1076,714,4,4,884,415,469,256,189,67,3
2021,Blaenau Gwent 004,W02000317,3441,2071,1129,942,5,5,933,389,544,423,365,58,9
2021,Blaenau Gwent 005,W02000318,4029,2387,1343,1044,4,4,1115,441,674,518,435,83,5
2021,Blaenau Gwent 006,W02000319,3814,2277,1272,1005,5,5,905,345,560,619,523,96,8
2021,Blaenau Gwent 007,W02000320,3707,2274,1312,962,2,2,591,158,433,837,731,106,3
2021,Blaenau Gwent 008,W02000321,3908,2348,1415,933,6,6,715,245,470,834,734,100,5
2021,Blaenau Gwent 009,W02000322,3152,1861,1126,735,2,2,604,211,393,685,599,86,0
2021,Torfaen 001,W02000323,2690,1565,913,652,5,5,705,231,474,412,333,79,3
2021,Torfaen 002,W02000324,2977,1842,1001,841,4,4,855,297,558,273,213,60,3
2021,Torfaen 003,W02000325,3063,1628,872,756,10,10,1136,446,690,281,224,57,8
2021,Torfaen 004,W02000326,3996,2521,1365,1156,23,23,847,301,546,604,505,99,1
2021,Torfaen 005,W02000327,2690,2115,1305,810,11,11,346,92,254,216,175,41,2
2021,Torfaen 006,W02000328,3256,2411,1266,1145,14,14,434,159,275,395,331,64,2
2021,Torfaen 007,W02000329,3533,2131,1046,1085,35,35,924,296,628,437,367,70,6
2021,Torfaen 008,W02000330,3249,2282,1347,935,0,0,547,164,383,420,351,69,0
2021,Torfaen 009,W02000331,2662,1271,626,645,2,2,1051,382,669,337,292,45,1
2021,Torfaen 010,W02000332,3481,1802,896,906,20,20,1273,463,810,382,311,71,4
2021,Torfaen 011,W02000333,2614,1776,895,881,73,73,507,193,314,256,217,39,2
2021,Torfaen 012,W02000334,2811,2096,1147,949,9,9,485,151,334,221,176,45,0
2021,Torfaen 013,W02000335,3219,2475,1273,1202,16,16,463,150,313,262,206,56,3
2021,Monmouthshire 001,W02000336,4003,2922,2012,910,9,9,374,88,286,695,559,136,3
2021,Monmouthshire 002,W02000337,3520,1988,1223,765,9,9,1108,350,758,411,344,67,4
2021,Monmouthshire 003,W02000338,3709,2867,1811,1056,18,18,443,130,313,381,302,79,0
2021,Monmouthshire 004,W02000339,5016,3343,2109,1234,30,30,872,170,702,768,644,124,3
2021,Monmouthshire 005,W02000340,3027,2190,1485,705,5,5,230,50,180,599,497,102,3
2021,Monmouthshire 006,W02000341,3554,2780,1779,1001,17,17,283,53,230,473,387,86,1
2021,Monmouthshire 007,W02000342,3927,3315,1951,1364,14,14,203,35,168,395,337,58,0
2021,Monmouthshire 008,W02000343,3839,2218,1166,1052,7,7,802,207,595,807,718,89,5
2021,Monmouthshire 009,W02000344,3569,2960,1615,1345,12,12,265,74,191,332,266,66,0
2021,Monmouthshire 010,W02000345,3512,2297,1352,945,14,14,835,261,574,363,307,56,3
2021,Monmouthshire 011,W02000346,3251,2548,1234,1314,13,13,333,76,257,357,313,44,0
2021,Newport 001,W02000347,3523,2737,1558,1179,12,12,372,199,173,394,328,66,8
2021,Newport 002,W02000348,3280,2454,1381,1073,10,10,479,270,209,333,275,58,4
2021,Newport 003,W02000349,3453,1646,852,794,39,39,1334,710,624,417,360,57,17
2021,Newport 004,W02000350,4020,3253,1436,1817,19,19,405,169,236,342,288,54,1
2021,Newport 005,W02000351,2697,1673,837,836,13,13,716,338,378,285,245,40,10
2021,Newport 006,W02000352,2967,1606,788,818,17,17,794,259,535,537,462,75,13
2021,Newport 007,W02000353,3102,2074,978,1096,42,42,243,62,181,739,651,88,4
2021,Newport 008,W02000354,2579,1698,941,757,7,7,586,187,399,283,231,52,5
2021,Newport 009,W02000355,4018,3339,1609,1730,25,25,308,154,154,344,303,41,2
2021,Newport 010,W02000356,2120,1004,535,469,1,1,908,557,351,200,175,25,7
2021,Newport 011,W02000357,3330,1985,989,996,11,11,329,83,246,998,908,90,7
2021,Newport 012,W02000358,2676,2169,1126,1043,6,6,150,29,121,350,300,50,1
2021,Newport 013,W02000359,4621,2229,884,1345,86,86,672,226,446,1623,1476,147,11
2021,Newport 014,W02000360,3142,1287,648,639,26,26,678,122,556,1147,1064,83,4
2021,Newport 015,W02000361,4704,2786,1327,1459,16,16,1307,633,674,588,517,71,7
2021,Newport 016,W02000362,3015,2198,999,1199,29,29,444,197,247,343,295,48,1
2021,Newport 017,W02000363,2608,1661,899,762,33,33,633,274,359,271,214,57,10
2021,Newport 018,W02000364,3419,1396,532,864,29,29,1022,403,619,955,817,138,17
2021,Newport 019,W02000365,3453,1619,628,991,38,38,1334,713,621,456,405,51,6
2021,Newport 020,W02000366,3326,2748,1224,1524,13,13,149,62,87,415,348,67,1
2021,Cardiff 001,W02000367,2525,2169,1266,903,8,8,53,23,30,295,253,42,0
2021,Cardiff 002,W02000368,2520,1914,1003,911,35,35,108,32,76,462,430,32,1
2021,Cardiff 003,W02000369,4027,2951,939,2012,27,27,289,29,260,760,696,64,0
2021,Cardiff 004,W02000370,2936,2652,1653,999,5,5,51,18,33,228,192,36,0
2021,Cardiff 005,W02000371,4095,2641,1301,1340,22,22,819,543,276,599,509,90,14
2021,Cardiff 006,W02000372,3337,2785,1372,1413,4,4,185,57,128,363,318,45,0
2021,Cardiff 007,W02000373,2881,1455,689,766,3,3,1067,701,366,340,283,57,16
2021,Cardiff 008,W02000374,2297,2025,1127,898,2,2,64,23,41,206,160,46,0
2021,Cardiff 009,W02000375,2854,1537,598,939,7,7,805,459,346,496,442,54,9
2021,Cardiff 010,W02000376,2974,2060,1092,968,5,5,589,345,244,312,259,53,8
2021,Cardiff 011,W02000377,3199,2180,884,1296,21,21,435,268,167,558,492,66,5
2021,Cardiff 012,W02000378,3138,2527,1411,1116,4,4,161,53,108,444,398,46,2
2021,Cardiff 013,W02000379,2583,862,364,498,12,12,1372,500,872,327,306,21,10
2021,Cardiff 014,W02000380,3242,2756,1466,1290,5,5,191,87,104,285,237,48,5
2021,Cardiff 015,W02000381,2812,1698,814,884,2,2,630,510,120,470,407,63,12
2021,Cardiff 016,W02000382,2433,1140,536,604,5,5,961,542,419,318,289,29,9
2021,Cardiff 017,W02000383,3117,1836,922,914,5,5,754,554,200,504,457,47,18
2021,Cardiff 018,W02000384,2313,1922,1040,882,13,13,96,35,61,281,227,54,1
2021,Cardiff 019,W02000385,2435,1973,1128,845,3,3,89,16,73,370,329,41,0
2021,Cardiff 020,W02000386,3253,2665,1569,1096,6,6,212,116,96,366,300,66,4
2021,Cardiff 021,W02000387,2420,1994,1111,883,9,9,39,20,19,378,339,39,0
2021,Cardiff 022,W02000388,2393,1830,990,840,7,7,301,172,129,248,205,43,7
2021,Cardiff 023,W02000389,3479,2147,991,1156,9,9,852,564,288,459,404,55,12
2021,Cardiff 024,W02000390,2359,1973,1216,757,2,2,108,13,95,274,237,37,2
2021,Cardiff 025,W02000391,2511,1186,530,656,7,7,267,134,133,1044,971,73,7
2021,Cardiff 026,W02000392,3756,3065,1754,1311,14,14,131,8,123,542,454,88,4
2021,Cardiff 027,W02000393,2965,1717,836,881,11,11,734,599,135,495,418,77,8
2021,Cardiff 028,W02000394,2913,812,413,399,13,13,133,29,104,1949,1883,66,6
2021,Cardiff 029,W02000395,2916,1813,895,918,8,8,294,21,273,797,750,47,4
2021,Cardiff 030,W02000396,2922,1363,604,759,10,10,139,66,73,1405,1319,86,5
2021,Cardiff 031,W02000397,2911,1860,948,912,4,4,727,406,321,312,278,34,8
2021,Cardiff 032,W02000398,3257,500,291,209,10,10,263,70,193,2480,2381,99,4
2021,Cardiff 033,W02000399,4800,1274,614,660,16,16,764,127,637,2736,2623,113,10
2021,Cardiff 034,W02000400,3153,1707,830,877,7,7,222,53,169,1216,1126,90,1
2021,Cardiff 035,W02000401,2688,1931,898,1033,4,4,274,32,242,478,440,38,1
2021,Cardiff 036,W02000402,4111,1239,530,709,9,9,1018,209,809,1819,1704,115,26
2021,Cardiff 037,W02000403,3250,1517,522,995,6,6,990,658,332,724,661,63,13
2021,Cardiff 038,W02000404,2864,1227,501,726,6,6,904,105,799,697,629,68,30
2021,Cardiff 039,W02000405,2988,999,440,559,4,4,1602,1474,128,360,330,30,23
2021,Cardiff 040,W02000406,4407,2701,1090,1611,11,11,707,158,549,983,869,114,5
2021,Cardiff 041,W02000407,2675,1212,600,612,13,13,1058,686,372,379,324,55,13
2021,Cardiff 042,W02000408,3017,1066,522,544,10,10,702,218,484,1225,1155,70,14
2021,Cardiff 043,W02000409,2594,1444,777,667,2,2,781,623,158,344,294,50,23
2021,Cardiff 044,W02000410,3072,1521,725,796,6,6,417,94,323,1120,1049,71,8
2021,Cardiff 045,W02000411,2738,1367,626,741,5,5,870,504,366,479,405,74,17
2021,Cardiff 046,W02000412,2768,1472,662,810,9,9,567,229,338,711,627,84,9
2021,Powys 020,W02000414,2614,2002,1439,563,9,9,150,112,38,453,340,113,0
2021,Merthyr Tydfil 008,W02000415,3807,1762,1036,726,4,4,1651,1016,635,371,297,74,19
2021,Powys 021,W02000416,4634,3226,2106,1120,7,7,853,680,173,528,399,129,20
2021,Neath Port Talbot 020,W02000417,4561,3091,1789,1302,6,6,883,441,442,575,451,124,6
2021,Carmarthenshire 027,W02000418,5330,4006,2641,1365,14,14,529,345,184,778,614,164,3
2021,Denbighshire 017,W02000419,5047,3605,2022,1583,45,45,518,322,196,872,747,125,7
2021,Ceredigion 011,W02000421,4997,3885,2698,1187,15,15,250,53,197,847,652,195,0
2021,Cardiff 048,W02000422,4216,1425,480,945,24,24,365,34,331,2401,2281,120,1
2021,Cardiff 049,W02000423,4216,1319,500,819,7,7,1115,665,450,1749,1618,131,26
2021,Wrexham 021,W02000424,2969,2503,1570,933,4,4,163,142,21,297,245,52,2
2021,Wrexham 022,W02000425,2874,2223,1212,1011,6,6,234,200,34,406,343,63,5
2021,Wrexham 023,W02000426,4396,3211,1913,1298,6,6,662,601,61,499,416,83,18
2021,Neath Port Talbot 021,W02000427,4886,3269,2006,1263,4,4,1007,413,594,601,482,119,5
2021,Swansea 032,W02000428,4425,3681,2204,1477,14,14,265,72,193,462,362,100,3
