date,geography,geography code,Tenure of household: Total: All households,Tenure of household: Owned,Tenure of household: Owned: Owns outright,Tenure of household: Owned: Owns with a mortgage or loan,Tenure of household: Shared ownership,Tenure of household: Shared ownership: Shared ownership,Tenure of household: Social rented,Tenure of household: Social rented: Rents from council or Local Authority,Tenure of household: Social rented: Other social rented,Tenure of household: Private rented,Tenure of household: Private rented: Private landlord or letting agency,Tenure of household: Private rented: Other private rented,Tenure of household: Lives rent free
2021,Hartlepool,E06000001,40929,23834,12761,11073,239,239,9594,3986,5608,7194,6338,856,68
2021,Middlesbrough,E06000002,60265,33137,17224,15913,330,330,14006,6773,7233,12677,11286,1391,115
2021,Redcar and Cleveland,E06000003,61638,39854,22649,17205,346,346,11649,5269,6380,9748,8410,1338,41
2021,Stockton-on-Tees,E06000004,83756,55412,27726,27686,385,385,13673,7204,6469,14207,12388,1819,79
2021,Darlington,E06000005,48915,30696,16222,14474,190,190,7931,5112,2819,10078,9035,1043,20
2021,Halton,E06000006,55951,33840,17096,16744,429,429,13619,2898,10721,8018,7088,930,45
2021,Warrington,E06000007,90538,62185,31939,30246,686,686,13842,4982,8860,13773,12193,1580,52
2021,Blackburn with Darwen,E06000008,58767,35531,19573,15958,308,308,11031,2718,8313,11850,10290,1560,47
2021,Blackpool,E06000009,64783,37234,20348,16886,213,213,6700,3947,2753,20569,18843,1726,67
2021,"Kingston upon Hull, City of",E06000010,115475,55741,26695,29046,585,585,31167,21768,9399,27593,25419,2174,389
2021,East Riding of Yorkshire,E06000011,152066,111198,65680,45518,634,634,14280,10874,3406,25732,22171,3561,222
2021,North East Lincolnshire,E06000012,69826,44584,24373,20211,358,358,9191,2729,6462,15644,14185,1459,49
2021,North Lincolnshire,E06000013,73172,49396,27829,21567,204,204,10953,5035,5918,12555,10929,1626,64
2021,York,E06000014,85458,55635,31453,24182,719,719,11924,7152,4772,17084,15209,1875,96
2021,Derby,E06000015,105651,62369,33384,28985,790,790,19851,11713,8138,22453,20395,2058,188
2021,Leicester,E06000016,127389,59430,31324,28106,662,662,29495,18748,10747,37437,34549,2888,365
2021,Rutland,E06000017,16691,11841,7286,4555,233,233,1819,310,1509,2790,2082,708,8
2021,Nottingham,E06000018,124743,56315,27940,28375,609,609,31796,22854,8942,35688,33039,2649,335
2021,"Herefordshire, County of",E06000019,82827,54963,35070,19893,916,916,11309,2657,8652,15605,12943,2662,34
2021,Telford and Wrekin,E06000020,76509,45864,23088,22776,586,586,13784,4966,8818,16197,14694,1503,78
2021,Stoke-on-Trent,E06000021,110400,62653,33558,29095,404,404,24569,16913,7656,22400,20065,2335,374
2021,Bath and North East Somerset,E06000022,79250,51733,28855,22878,790,790,11363,3064,8299,15309,13758,1551,55
2021,"Bristol, City of",E06000023,191638,103420,48199,55221,1656,1656,35879,24977,10902,50213,46271,3942,470
2021,North Somerset,E06000024,94648,67782,37250,30532,679,679,8714,2003,6711,17420,15541,1879,53
2021,South Gloucestershire,E06000025,118101,85492,43220,42272,1231,1231,12738,2122,10616,18588,16441,2147,52
2021,Plymouth,E06000026,114557,66038,33783,32255,1349,1349,21111,7386,13725,25921,22754,3167,138
2021,Torbay,E06000027,62992,40362,24663,15699,622,622,5225,561,4664,16767,15195,1572,16
2021,Swindon,E06000030,95861,61043,27968,33075,1203,1203,14944,9786,5158,18520,16798,1722,151
2021,Peterborough,E06000031,84533,46892,22268,24624,1167,1167,15760,5009,10751,20612,18675,1937,102
2021,Luton,E06000032,78940,42577,20296,22281,426,426,12923,8498,4425,22887,21280,1607,127
2021,Southend-on-Sea,E06000033,78344,48023,24722,23301,503,503,9019,4822,4197,20759,19085,1674,40
2021,Thurrock,E06000034,66377,42020,16912,25108,445,445,11733,9639,2094,12131,11015,1116,48
2021,Medway,E06000035,111457,72122,34388,37734,1646,1646,15130,4553,10577,22491,20219,2272,68
2021,Bracknell Forest,E06000036,50245,33541,14488,19053,877,877,7889,2507,5382,7902,6957,945,36
2021,West Berkshire,E06000037,66658,45037,23209,21828,878,878,9305,787,8518,11431,9668,1763,7
2021,Reading,E06000038,67683,34133,15426,18707,883,883,10924,6145,4779,21623,20373,1250,120
2021,Slough,E06000039,52423,25401,10215,15186,573,573,10266,6304,3962,16095,15101,994,88
2021,Windsor and Maidenhead,E06000040,60929,40306,20393,19913,392,392,7655,705,6950,12553,10635,1918,23
2021,Wokingham,E06000041,69165,52599,24952,27647,1426,1426,5331,2844,2487,9782,8665,1117,27
2021,Milton Keynes,E06000042,113103,61945,27193,34752,6905,6905,20448,11029,9419,23656,21780,1876,149
2021,Brighton and Hove,E06000043,121402,62417,30444,31973,997,997,18051,11587,6464,39684,37167,2517,253
2021,Portsmouth,E06000044,86155,45024,21958,23066,769,769,15507,9394,6113,24669,22196,2473,186
2021,Southampton,E06000045,102290,48838,23049,25789,1061,1061,22397,14958,7439,29860,28063,1797,134
2021,Isle of Wight,E06000046,64775,43820,28737,15083,509,509,7057,678,6379,13380,11731,1649,9
2021,County Durham,E06000047,234764,146821,81046,65775,692,692,46858,21999,24859,40198,35156,5042,195
2021,Cheshire East,E06000049,174854,125646,69191,56455,1772,1772,20243,4659,15584,27114,23868,3246,79
2021,Cheshire West and Chester,E06000050,155154,105956,57620,48336,1945,1945,22710,9412,13298,24384,21291,3093,159
2021,Shropshire,E06000051,139579,95784,59262,36522,1170,1170,18169,5616,12553,24367,20425,3942,89
2021,Cornwall,E06000052,250533,165958,104659,61299,2949,2949,32039,13023,19016,49371,41545,7826,216
2021,Isles of Scilly,E06000053,939,418,320,98,14,14,162,103,59,344,224,120,1
2021,Wiltshire,E06000054,215081,143767,80220,63547,2546,2546,31228,7845,23383,37422,27674,9748,118
2021,Bedford,E06000055,74949,46964,23359,23605,1427,1427,12200,1782,10418,14316,12905,1411,42
2021,Central Bedfordshire,E06000056,120754,85923,40618,45305,2112,2112,16077,5620,10457,16567,14329,2238,75
2021,Northumberland,E06000057,146922,95788,56684,39104,801,801,26085,13597,12488,24128,20149,3979,120
2021,"Bournemouth, Christchurch and Poole",E06000058,173842,109221,59736,49485,1226,1226,19102,8864,10238,44152,40460,3692,141
2021,Dorset,E06000059,169261,119154,77561,41593,1620,1620,20836,2263,18573,27612,22778,4834,39
2021,Buckinghamshire,E06000060,220327,154239,77213,77026,2813,2813,28535,5766,22769,34630,29769,4861,110
2021,North Northamptonshire,E06000061,148918,96862,47617,49245,1760,1760,22671,10410,12261,27455,24645,2810,170
2021,West Northamptonshire,E06000062,172639,111955,53782,58173,2647,2647,24811,12035,12776,33000,29463,3537,226
2021,Cambridge,E07000008,52474,23131,12897,10234,872,872,11890,6910,4980,16495,14735,1760,86
2021,East Cambridgeshire,E07000009,37202,25307,13485,11822,565,565,5200,684,4516,6120,5103,1017,10
2021,Fenland,E07000010,44083,29452,16632,12820,236,236,5581,1174,4407,8795,7788,1007,19
2021,Huntingdonshire,E07000011,76880,53023,27621,25402,1051,1051,9886,1819,8067,12897,11117,1780,23
2021,South Cambridgeshire,E07000012,66996,46162,24426,21736,1677,1677,9696,5397,4299,9383,8055,1328,78
2021,Allerdale,E07000026,43973,30046,18770,11276,241,241,8313,1096,7217,5363,4241,1122,10
2021,Barrow-in-Furness,E07000027,31259,22461,12250,10211,54,54,3451,2388,1063,5259,4588,671,34
2021,Carlisle,E07000028,50663,34047,19427,14620,419,419,7272,1402,5870,8900,7687,1213,25
2021,Copeland,E07000029,30788,21837,12988,8849,98,98,5429,1635,3794,3399,2726,673,25
2021,Eden,E07000030,24613,17363,11661,5702,256,256,2542,399,2143,4452,3522,930,0
2021,South Lakeland,E07000031,47657,34267,22394,11873,276,276,5112,2201,2911,7974,6525,1449,28
2021,Amber Valley,E07000032,56277,40525,23051,17474,297,297,7169,2302,4867,8235,7174,1061,51
2021,Bolsover,E07000033,35262,23264,12391,10873,117,117,5762,4647,1115,6056,5373,683,63
2021,Chesterfield,E07000034,48058,30073,17249,12824,158,158,9967,8428,1539,7781,6882,899,79
2021,Derbyshire Dales,E07000035,32283,23229,15405,7824,319,319,4075,942,3133,4650,3731,919,10
2021,Erewash,E07000036,50336,35172,18887,16285,265,265,6398,1775,4623,8470,7518,952,31
2021,High Peak,E07000037,40772,28929,16367,12562,284,284,4957,3610,1347,6545,5633,912,57
2021,North East Derbyshire,E07000038,45987,32426,18959,13467,270,270,8597,7020,1577,4608,3841,767,86
2021,South Derbyshire,E07000039,45239,33709,16388,17321,368,368,4466,2780,1686,6648,5836,812,48
2021,East Devon,E07000040,66788,48195,31228,16967,947,947,6898,4030,2868,10697,8960,1737,51
2021,Exeter,E07000041,52554,30072,16369,13703,583,583,8727,4640,4087,13107,12024,1083,65
2021,Mid Devon,E07000042,35631,24098,14110,9988,365,365,4504,2830,1674,6612,5704,908,52
2021,North Devon,E07000043,43198,29080,18055,11025,477,477,4811,1110,3701,8813,7364,1449,17
2021,South Hams,E07000044,39337,27716,17708,10008,628,628,4653,728,3925,6326,5258,1068,14
2021,Teignbridge,E07000045,59837,42659,25889,16770,775,775,5694,1324,4370,10683,9357,1326,26
2021,Torridge,E07000046,30458,21186,13870,7316,265,265,2847,467,2380,6152,5157,995,8
2021,West Devon,E07000047,24818,17612,11569,6043,176,176,2495,495,2000,4526,3830,696,9
2021,Eastbourne,E07000061,45610,27229,16305,10924,270,270,5940,3223,2717,12118,11117,1001,53
2021,Hastings,E07000062,40451,22887,12644,10243,203,203,5771,918,4853,11572,10642,930,18
2021,Lewes,E07000063,43688,31073,18524,12549,410,410,4774,3162,1612,7384,6524,860,47
2021,Rother,E07000064,42102,30605,20395,10210,372,372,4293,645,3648,6827,5862,965,5
2021,Wealden,E07000065,68266,52543,30510,22033,794,794,5701,2887,2814,9203,7658,1545,25
2021,Basildon,E07000066,76363,48297,23029,25268,876,876,16213,10563,5650,10876,9762,1114,101
2021,Braintree,E07000067,64983,44090,22262,21828,475,475,10593,2187,8406,9795,8573,1222,30
2021,Brentwood,E07000068,32343,23258,11797,11461,214,214,3660,2649,1011,5163,4589,574,48
2021,Castle Point,E07000069,37389,29937,16937,13000,135,135,2051,1423,628,5240,4585,655,26
2021,Chelmsford,E07000070,75401,52748,27057,25691,879,879,10017,1619,8398,11724,10479,1245,33
2021,Colchester,E07000071,79711,51478,26126,25352,419,419,10585,5645,4940,17165,15003,2162,64
2021,Epping Forest,E07000072,54559,37987,19180,18807,353,353,7993,6215,1778,8147,7082,1065,79
2021,Harlow,E07000073,37856,20345,8723,11622,499,499,11097,9051,2046,5824,5298,526,91
2021,Maldon,E07000074,27900,21258,12224,9034,227,227,3132,266,2866,3279,2670,609,4
2021,Rochford,E07000075,35558,28674,15572,13102,205,205,2871,365,2506,3805,3203,602,3
2021,Tendring,E07000076,67452,48214,31510,16704,315,315,5506,2702,2804,13370,11829,1541,47
2021,Uttlesford,E07000077,36955,26086,13177,12909,659,659,4809,2682,2127,5375,4519,856,26
2021,Cheltenham,E07000078,52899,33635,18362,15273,397,397,6432,4069,2363,12378,11406,972,57
2021,Cotswold,E07000079,40597,26437,16177,10260,869,869,6232,675,5557,7049,5592,1457,10
2021,Forest of Dean,E07000080,37217,27018,16466,10552,319,319,4836,832,4004,5031,4072,959,13
2021,Gloucester,E07000081,55406,35379,17510,17869,630,630,7537,2797,4740,11803,10691,1112,57
2021,Stroud,E07000082,52378,38080,21548,16532,631,631,6430,4521,1909,7153,6125,1028,84
2021,Tewkesbury,E07000083,40931,28959,15984,12975,918,918,5198,865,4333,5841,4763,1078,15
2021,Basingstoke and Deane,E07000084,76645,49645,23475,26170,1475,1475,13711,765,12946,11800,10412,1388,14
2021,East Hampshire,E07000085,52719,38471,21080,17391,756,756,6607,920,5687,6876,5692,1184,9
2021,Eastleigh,E07000086,56924,40391,20012,20379,1160,1160,7430,673,6757,7936,7081,855,7
2021,Fareham,E07000087,48639,38191,21154,17037,342,342,3959,2237,1722,6106,4990,1116,41
2021,Gosport,E07000088,35920,22849,12314,10535,434,434,5862,2998,2864,6714,5481,1233,61
2021,Hart,E07000089,39965,30262,14958,15304,742,742,3514,370,3144,5442,4428,1014,5
2021,Havant,E07000090,53589,36395,20869,15526,469,469,9989,5040,4949,6655,5760,895,81
2021,New Forest,E07000091,77567,57521,36150,21371,504,504,8367,4976,3391,11124,9259,1865,51
2021,Rushmoor,E07000092,39303,23774,9979,13795,679,679,6369,945,5424,8449,6510,1939,32
2021,Test Valley,E07000093,54706,37716,19742,17974,1049,1049,7842,1935,5907,8070,6356,1714,29
2021,Winchester,E07000094,51712,33918,18648,15270,702,702,7937,4950,2987,9096,7489,1607,59
2021,Broxbourne,E07000095,39850,27357,13178,14179,420,420,5683,1400,4283,6367,5783,584,23
2021,Dacorum,E07000096,63412,40535,19598,20937,394,394,13320,9863,3457,9093,8214,879,70
2021,Hertsmere,E07000098,42682,27399,13227,14172,488,488,7401,873,6528,7370,6544,826,24
2021,North Hertfordshire,E07000099,56733,36761,18933,17828,642,642,10594,3476,7118,8722,7756,966,14
2021,Three Rivers,E07000102,36857,26140,12806,13334,276,276,5467,1518,3949,4956,4296,660,18
2021,Watford,E07000103,39629,21845,9577,12268,419,419,6172,1531,4641,11177,10505,672,16
2021,Ashford,E07000105,53583,35597,18032,17565,917,917,7501,4750,2751,9499,8236,1263,69
2021,Canterbury,E07000106,63792,41313,24477,16836,586,586,7800,5006,2794,14024,12522,1502,69
2021,Dartford,E07000107,45694,29996,12302,17694,1042,1042,6314,4274,2040,8275,7617,658,67
2021,Dover,E07000108,50552,33478,19753,13725,387,387,7039,4196,2843,9595,8379,1216,53
2021,Gravesham,E07000109,41724,25960,13018,12942,443,443,7270,5308,1962,7950,7276,674,101
2021,Maidstone,E07000110,71208,47991,24192,23799,1350,1350,9507,1887,7620,12339,10725,1614,21
2021,Sevenoaks,E07000111,49014,35066,18769,16297,913,913,6465,996,5469,6548,5572,976,22
2021,Folkestone and Hythe,E07000112,48337,31807,18966,12841,365,365,5251,3153,2098,10870,9555,1315,44
2021,Swale,E07000113,60495,40515,20788,19727,820,820,8041,1325,6716,11102,9851,1251,17
2021,Thanet,E07000114,62200,38162,22731,15431,282,282,7396,2940,4456,16334,14755,1579,26
2021,Tonbridge and Malling,E07000115,53571,37505,18379,19126,1108,1108,8255,1001,7254,6694,5757,937,9
2021,Tunbridge Wells,E07000116,48224,31393,16324,15069,521,521,7029,946,6083,9268,8297,971,13
2021,Burnley,E07000117,39871,23836,13051,10785,91,91,6209,1747,4462,9696,8621,1075,39
2021,Chorley,E07000118,50135,36156,18558,17598,358,358,6637,1218,5419,6964,6056,908,20
2021,Fylde,E07000119,37606,26944,16369,10575,288,288,3134,404,2730,7230,6239,991,10
2021,Hyndburn,E07000120,34790,21944,11917,10027,80,80,4711,1222,3489,8035,7088,947,20
2021,Lancaster,E07000121,59978,40266,23152,17114,488,488,6153,3384,2769,13029,11460,1569,42
2021,Pendle,E07000122,38066,24726,14127,10599,77,77,4491,1421,3070,8741,7622,1119,31
2021,Preston,E07000123,59607,34743,18219,16524,511,511,10983,1882,9101,13333,11923,1410,37
2021,Ribble Valley,E07000124,26747,20187,11654,8533,405,405,2151,292,1859,4003,3273,730,1
2021,Rossendale,E07000125,30561,20750,10560,10190,72,72,4514,1186,3328,5207,4459,748,18
2021,South Ribble,E07000126,48585,36947,19428,17519,376,376,5039,496,4543,6217,5339,878,6
2021,West Lancashire,E07000127,48534,34324,18987,15337,443,443,6958,5517,1441,6722,5754,968,87
2021,Wyre,E07000128,50769,37238,22699,14539,407,407,3871,544,3327,9241,8064,1177,12
2021,Blaby,E07000129,42575,33162,17012,16150,459,459,3497,482,3015,5449,4761,688,8
2021,Charnwood,E07000130,73785,51535,27619,23916,738,738,8632,4921,3711,12814,11541,1273,66
2021,Harborough,E07000131,40414,30632,16484,14148,805,805,3531,405,3126,5439,4687,752,7
2021,Hinckley and Bosworth,E07000132,49445,36789,19715,17074,451,451,5049,3005,2044,7114,6199,915,42
2021,Melton,E07000133,22599,16031,9160,6871,249,249,2416,1641,775,3881,3382,499,22
2021,North West Leicestershire,E07000134,44974,32289,16599,15690,479,479,6089,4066,2023,6074,5385,689,43
2021,Oadby and Wigston,E07000135,22616,17015,9711,7304,160,160,1793,1116,677,3623,3248,375,25
2021,Boston,E07000136,29404,17305,9967,7338,376,376,5726,1969,3757,5965,5425,540,32
2021,East Lindsey,E07000137,64754,43645,29907,13738,686,686,7295,1495,5800,13110,10971,2139,18
2021,Lincoln,E07000138,42506,21466,11092,10374,387,387,8953,7162,1791,11558,10634,924,142
2021,North Kesteven,E07000139,50989,37110,20386,16724,536,536,5113,3685,1428,8164,6299,1865,66
2021,South Holland,E07000140,40703,28321,16604,11717,436,436,4936,3693,1243,6943,6055,888,67
2021,South Kesteven,E07000141,62847,42920,23765,19155,654,654,7851,5536,2315,11325,9998,1327,97
2021,West Lindsey,E07000142,42345,29759,17553,12206,391,391,4605,1190,3415,7570,6431,1139,20
2021,Breckland,E07000143,60358,40461,24126,16335,433,433,8507,1653,6854,10930,9186,1744,27
2021,Broadland,E07000144,57760,44536,26448,18088,498,498,5619,650,4969,7095,5951,1144,12
2021,Great Yarmouth,E07000145,44545,27516,16978,10538,133,133,7213,5464,1749,9576,8504,1072,107
2021,King's Lynn and West Norfolk,E07000146,67464,45203,28053,17150,323,323,9180,2167,7013,12704,10482,2222,54
2021,North Norfolk,E07000147,48374,33210,23509,9701,333,333,6275,998,5277,8538,7170,1368,18
2021,Norwich,E07000148,64457,27105,14312,12793,367,367,19518,14240,5278,17351,15986,1365,116
2021,South Norfolk,E07000149,61381,44895,25720,19175,756,756,7184,1411,5773,8527,7213,1314,19
2021,Craven,E07000163,26069,18663,11826,6837,184,184,2494,457,2037,4718,3963,755,10
2021,Hambleton,E07000164,40800,28145,17772,10373,355,355,5468,575,4893,6826,5245,1581,6
2021,Harrogate,E07000165,71169,49907,28936,20971,647,647,7022,3740,3282,13522,11484,2038,71
2021,Richmondshire,E07000166,20946,13492,8518,4974,119,119,2441,1450,991,4866,3142,1724,28
2021,Ryedale,E07000167,24715,16506,10820,5686,190,190,3171,331,2840,4841,3958,883,7
2021,Scarborough,E07000168,51124,32472,21164,11308,484,484,7070,1250,5820,11081,9748,1333,17
2021,Selby,E07000169,39562,28915,14590,14325,447,447,4851,2923,1928,5310,4571,739,39
2021,Ashfield,E07000170,54509,36750,19484,17266,221,221,8130,6135,1995,9297,8261,1036,111
2021,Bassetlaw,E07000171,51458,35114,19442,15672,217,217,7697,6124,1573,8351,7210,1141,79
2021,Broxtowe,E07000172,48362,34454,19301,15153,151,151,5337,4029,1308,8355,7409,946,65
2021,Gedling,E07000173,51551,38066,20649,17417,270,270,4995,2084,2911,8191,7136,1055,29
2021,Mansfield,E07000174,48031,30756,16668,14088,214,214,7865,5738,2127,9065,8156,909,131
2021,Newark and Sherwood,E07000175,53332,36793,20525,16268,437,437,7413,5133,2280,8624,7476,1148,65
2021,Rushcliffe,E07000176,49883,37761,20508,17253,524,524,4273,886,3387,7312,6450,862,13
2021,Cherwell,E07000177,65893,42839,21431,21408,1253,1253,8742,1427,7315,13033,11453,1580,26
2021,Oxford,E07000178,55239,25035,13993,11042,793,793,11554,7414,4140,17762,16150,1612,95
2021,South Oxfordshire,E07000179,61498,43195,23180,20015,1116,1116,7386,1092,6294,9784,7921,1863,17
2021,Vale of White Horse,E07000180,57497,39210,20812,18398,1055,1055,8206,1260,6946,9002,7003,1999,24
2021,West Oxfordshire,E07000181,47981,32045,17963,14082,995,995,6363,788,5575,8570,6580,1990,8
2021,Mendip,E07000187,50294,34541,20657,13884,605,605,6051,1149,4902,9077,7770,1307,20
2021,Sedgemoor,E07000188,53904,36821,21144,15677,493,493,6887,3618,3269,9651,8494,1157,52
2021,South Somerset,E07000189,75936,51581,31355,20226,840,840,10733,2166,8567,12734,10552,2182,48
2021,Cannock Chase,E07000192,43456,29156,14718,14438,297,297,7031,4894,2137,6862,6109,753,110
2021,East Staffordshire,E07000193,51293,34278,18695,15583,357,357,6634,2276,4358,9992,8846,1146,32
2021,Lichfield,E07000194,45632,33430,18902,14528,445,445,5932,738,5194,5817,4926,891,8
2021,Newcastle-under-Lyme,E07000195,53423,36151,20435,15716,350,350,9142,2774,6368,7735,6613,1122,45
2021,South Staffordshire,E07000196,46121,34359,20310,14049,402,402,6471,625,5846,4873,4126,747,16
2021,Stafford,E07000197,60047,42032,23474,18558,500,500,8146,2042,6104,9336,7788,1548,33
2021,Staffordshire Moorlands,E07000198,42355,33141,20401,12740,164,164,3653,1069,2584,5373,4501,872,24
2021,Tamworth,E07000199,32895,22037,10967,11070,233,233,5926,4104,1822,4643,4192,451,56
2021,Babergh,E07000200,40200,28558,17460,11098,289,289,5333,3370,1963,5959,4910,1049,61
2021,Ipswich,E07000202,59507,32992,16810,16182,353,353,12368,7614,4754,13664,12583,1081,130
2021,Mid Suffolk,E07000203,44344,32758,19151,13607,446,446,5011,3141,1870,6079,4874,1205,50
2021,Elmbridge,E07000207,55587,39641,18809,20832,586,586,5608,939,4669,9725,8828,897,27
2021,Epsom and Ewell,E07000208,31321,23167,11364,11803,358,358,2743,193,2550,5048,4561,487,5
2021,Guildford,E07000209,55760,36984,19267,17717,729,729,7066,4864,2202,10930,9552,1378,51
2021,Mole Valley,E07000210,37139,27189,15136,12053,380,380,4327,574,3753,5238,4506,732,5
2021,Reigate and Banstead,E07000211,59849,42570,20196,22374,969,969,6907,1082,5825,9387,8482,905,16
2021,Runnymede,E07000212,34838,23141,11431,11710,506,506,4499,2771,1728,6652,5907,745,40
2021,Spelthorne,E07000213,41804,28469,13980,14489,531,531,5296,771,4525,7487,6783,704,21
2021,Surrey Heath,E07000214,36008,26651,13156,13495,364,364,3449,477,2972,5531,4611,920,13
2021,Tandridge,E07000215,35623,26529,13326,13203,412,412,3939,2496,1443,4730,3973,757,13
2021,Waverley,E07000216,52448,37637,20039,17598,642,642,6427,4657,1770,7703,6494,1209,39
2021,Woking,E07000217,41438,27531,13251,14280,338,338,4792,2965,1827,8738,7966,772,39
2021,North Warwickshire,E07000218,27581,19414,10558,8856,261,261,3752,2490,1262,4110,3588,522,44
2021,Nuneaton and Bedworth,E07000219,56585,38504,19829,18675,461,461,8157,5412,2745,9399,8355,1044,64
2021,Rugby,E07000220,47015,31715,15703,16012,692,692,6074,3399,2675,8474,7460,1014,60
2021,Stratford-on-Avon,E07000221,59463,42123,24156,17967,1060,1060,7906,958,6948,8363,7055,1308,11
2021,Warwick,E07000222,62618,40952,21411,19541,899,899,8804,5251,3553,11910,10844,1066,53
2021,Adur,E07000223,27678,19936,11101,8835,184,184,3436,2431,1005,4095,3537,558,27
2021,Arun,E07000224,72661,51770,32182,19588,836,836,6774,3210,3564,13225,11801,1424,56
2021,Chichester,E07000225,54118,35372,22715,12657,754,754,8157,1057,7100,9807,8089,1718,28
2021,Crawley,E07000226,45502,25363,10940,14423,560,560,10432,7969,2463,9015,8352,663,132
2021,Horsham,E07000227,62370,45065,24482,20583,1072,1072,7155,775,6380,9055,7795,1260,23
2021,Mid Sussex,E07000228,63349,46013,23259,22754,810,810,6812,460,6352,9710,8568,1142,4
2021,Worthing,E07000229,49538,33440,18052,15388,322,322,4845,1051,3794,10916,10012,904,15
2021,Bromsgrove,E07000234,41264,31994,17483,14511,458,458,4417,1452,2965,4379,3719,660,16
2021,Malvern Hills,E07000235,34889,24773,15753,9020,451,451,5001,753,4248,4653,3896,757,11
2021,Redditch,E07000236,36378,23438,11254,12184,291,291,7331,5281,2050,5243,4718,525,75
2021,Worcester,E07000237,44724,27462,14320,13142,472,472,7269,2155,5114,9494,8593,901,27
2021,Wychavon,E07000238,57356,40185,23188,16997,708,708,8954,1478,7476,7493,6337,1156,16
2021,Wyre Forest,E07000239,45320,31158,18477,12681,464,464,6411,2946,3465,7239,6366,873,48
2021,St Albans,E07000240,58990,41852,20615,21237,297,297,7187,4620,2567,9602,8703,899,52
2021,Welwyn Hatfield,E07000241,46209,26176,12711,13465,647,647,11714,8354,3360,7586,6954,632,86
2021,East Hertfordshire,E07000242,62023,43010,21140,21870,915,915,8111,1041,7070,9967,8910,1057,20
2021,Stevenage,E07000243,36512,20804,9522,11282,618,618,9594,7457,2137,5470,4996,474,26
2021,East Suffolk,E07000244,110749,76280,49014,27266,443,443,14477,5093,9384,19485,16953,2532,64
2021,West Suffolk,E07000245,78747,47389,26398,20991,942,942,12735,3962,8773,17629,15003,2626,52
2021,Somerset West and Taunton,E07000246,69986,45759,27731,18028,655,655,10615,5568,5047,12869,11118,1751,88
2021,Bolton,E08000001,118790,73083,39475,33608,493,493,23555,12540,11015,21372,18776,2596,287
2021,Bury,E08000002,80696,53992,27752,26240,292,292,12044,6718,5326,14249,12628,1621,119
2021,Manchester,E08000003,214730,79925,35423,44502,1679,1679,63276,24419,38857,69403,65041,4362,447
2021,Oldham,E08000004,93140,56229,29384,26845,412,412,19760,7572,12188,16498,14253,2245,241
2021,Rochdale,E08000005,90222,54377,27411,26966,342,342,18815,9972,8843,16503,14535,1968,185
2021,Salford,E08000006,115117,54068,25294,28774,646,646,29227,13599,15628,30853,28651,2202,323
2021,Stockport,E08000007,126648,90025,46498,43527,1486,1486,16849,9880,6969,18192,16238,1954,96
2021,Tameside,E08000008,99527,60521,30363,30158,320,320,21125,5556,15569,17459,15489,1970,102
2021,Trafford,E08000009,96269,66387,33149,33238,654,654,14419,4065,10354,14744,13254,1490,65
2021,Wigan,E08000010,143105,94978,49212,45766,655,655,24333,20083,4250,22761,20040,2721,378
2021,Knowsley,E08000011,66073,39286,18902,20384,543,543,16687,7109,9578,9461,8366,1095,96
2021,Liverpool,E08000012,207491,97041,50393,46648,1378,1378,54758,9355,45403,54067,49950,4117,247
2021,St. Helens,E08000013,81013,52049,28023,24026,627,627,15993,5030,10963,12264,10785,1479,80
2021,Sefton,E08000014,123073,81991,46426,35565,845,845,17735,4159,13576,22457,20029,2428,45
2021,Wirral,E08000015,143252,93114,51333,41781,887,887,22065,5611,16454,27091,24397,2694,95
2021,Barnsley,E08000016,108053,67353,35620,31733,522,522,21294,16772,4522,18569,16296,2273,315
2021,Doncaster,E08000017,133480,83883,44881,39002,563,563,22694,18396,4298,25941,22953,2988,399
2021,Rotherham,E08000018,113926,72496,38318,34178,467,467,23545,18981,4564,17035,14651,2384,383
2021,Sheffield,E08000019,231948,135177,71903,63274,776,776,52334,36110,16224,43424,38976,4448,237
2021,Newcastle upon Tyne,E08000021,122797,60476,30707,29769,580,580,33476,24431,9045,27978,25300,2678,287
2021,North Tyneside,E08000022,96232,61271,31038,30233,504,504,19765,14069,5696,14625,12755,1870,67
2021,South Tyneside,E08000023,68288,38655,20503,18152,336,336,20208,15720,4488,9025,7742,1283,64
2021,Sunderland,E08000024,122177,70992,38312,32680,484,484,32554,13760,18794,18096,15827,2269,51
2021,Birmingham,E08000025,423455,223016,114970,108046,3641,3641,99499,58609,40890,95719,86669,9050,1580
2021,Coventry,E08000026,134140,77062,40278,36784,906,906,22766,7244,15522,33195,30134,3061,211
2021,Dudley,E08000027,137069,91053,51133,39920,618,618,26021,21157,4864,18940,16644,2296,437
2021,Sandwell,E08000028,130246,70004,35924,34080,631,631,34612,27293,7319,24237,21710,2527,762
2021,Solihull,E08000029,89482,64638,35054,29584,710,710,12532,8901,3631,11496,10249,1247,106
2021,Walsall,E08000030,112226,66589,36296,30293,557,557,26576,9241,17335,18336,16323,2013,168
2021,Wolverhampton,E08000031,105142,57810,31345,26465,445,445,26484,19761,6723,20006,17922,2084,397
2021,Bradford,E08000032,209867,129573,66875,62698,1043,1043,30731,11798,18933,48278,42709,5569,242
2021,Calderdale,E08000033,90476,58439,31269,27170,366,366,13170,3793,9377,18437,16210,2227,64
2021,Kirklees,E08000034,177989,116608,62352,54256,676,676,26288,19678,6610,33942,29858,4084,475
2021,Leeds,E08000035,341466,194584,95452,99132,1947,1947,69742,51716,18026,74402,68197,6205,791
2021,Wakefield,E08000036,153075,95826,48566,47260,1200,1200,33188,22323,10865,22754,19969,2785,107
2021,Gateshead,E08000037,88999,51609,27161,24448,350,350,22334,17308,5026,14584,12920,1664,122
2021,City of London,E09000001,4914,1794,1114,680,12,12,730,449,281,2373,2064,309,5
2021,Barking and Dagenham,E09000002,73902,31319,11130,20189,1274,1274,23273,18077,5196,17890,16443,1447,146
2021,Barnet,E09000003,148917,78407,39083,39324,1633,1633,20034,10030,10004,48705,45180,3525,138
2021,Bexley,E09000004,95300,65417,31210,34207,1263,1263,13977,2491,11486,14578,13078,1500,65
2021,Brent,E09000005,118612,45593,23933,21660,2246,2246,27876,10444,17432,42726,39732,2994,171
2021,Bromley,E09000006,135828,93028,44794,48234,1166,1166,17926,2090,15836,23661,21418,2243,47
2021,Camden,E09000007,92758,27507,14780,12727,715,715,31250,21051,10199,33012,30382,2630,274
2021,Croydon,E09000008,152945,83667,36992,46675,2183,2183,27371,14769,12602,39441,36484,2957,283
2021,Ealing,E09000009,133657,61814,30275,31539,2658,2658,23382,11326,12056,45490,42063,3427,313
2021,Enfield,E09000010,120923,63347,31740,31607,1319,1319,20573,12530,8043,35388,32773,2615,296
2021,Greenwich,E09000011,114051,46927,18473,28454,2471,2471,35327,21257,14070,29088,26863,2225,238
2021,Hackney,E09000012,106081,26066,10263,15803,2664,2664,42945,21943,21002,34147,31943,2204,259
2021,Hammersmith and Fulham,E09000013,81244,26090,12483,13607,1208,1208,24231,11840,12391,29558,27284,2274,157
2021,Haringey,E09000014,105091,39116,18141,20975,1732,1732,26474,15630,10844,37376,35052,2324,393
2021,Harrow,E09000015,89642,52690,26947,25743,1007,1007,9298,4977,4321,26495,24354,2141,152
2021,Havering,E09000016,101276,70379,34918,35461,976,976,13807,9423,4384,16019,14452,1567,95
2021,Hillingdon,E09000017,109228,61831,28994,32837,1373,1373,17613,10179,7434,28276,25692,2584,135
2021,Hounslow,E09000018,102961,47044,21761,25283,2225,2225,21618,13251,8367,31788,29537,2251,286
2021,Islington,E09000019,96496,25740,11151,14589,1580,1580,38787,24081,14706,30079,28084,1995,310
2021,Kensington and Chelsea,E09000020,66884,21191,13301,7890,676,676,18430,7154,11276,26460,23560,2900,127
2021,Kingston upon Thames,E09000021,65628,39937,18519,21418,460,460,7244,4647,2597,17911,16535,1376,76
2021,Lambeth,E09000022,134688,44469,16180,28289,2441,2441,45243,24126,21117,42329,39228,3101,206
2021,Lewisham,E09000023,122393,51230,18853,32377,1944,1944,35753,16045,19708,33289,30797,2492,177
2021,Merton,E09000024,81726,45468,20695,24773,869,869,11599,2342,9257,23748,21998,1750,42
2021,Newham,E09000025,115511,35579,14695,20884,2739,2739,32390,17989,14401,44479,41391,3088,324
2021,Redbridge,E09000026,103714,59221,27956,31265,983,983,11707,6604,5103,31576,29079,2497,227
2021,Richmond upon Thames,E09000027,80704,50361,24535,25826,560,560,9752,1829,7923,19970,18393,1577,61
2021,Southwark,E09000028,130820,37749,13879,23870,3182,3182,51991,35433,16558,37506,34493,3013,392
2021,Sutton,E09000029,82347,53047,23400,29647,889,889,11667,5399,6268,16683,15372,1311,61
2021,Tower Hamlets,E09000030,120539,27883,9424,18459,3143,3143,43237,16697,26540,46000,43126,2874,276
2021,Waltham Forest,E09000031,102901,50356,20817,29539,1700,1700,22099,10737,11362,28593,26361,2232,153
2021,Wandsworth,E09000032,137392,58325,24410,33915,2509,2509,26544,16653,9891,49830,46295,3535,184
2021,Westminster,E09000033,94816,25962,15213,10749,695,695,26810,12418,14392,41065,36871,4194,284
2021,Isle of Anglesey,W06000001,30824,21020,13756,7264,87,87,4820,3783,1037,4799,3735,1064,98
2021,Gwynedd,W06000002,51105,33428,22214,11214,150,150,8557,3524,5033,8865,7060,1805,105
2021,Conwy,W06000003,52235,35726,22759,12967,291,291,6257,2051,4206,9920,8526,1394,41
2021,Denbighshire,W06000004,42387,27940,16828,11112,234,234,5648,3298,2350,8492,7295,1197,73
2021,Flintshire,W06000005,66911,48019,25945,22074,307,307,9714,6985,2729,8839,7544,1295,32
2021,Wrexham,W06000006,57915,36218,19947,16271,182,182,12161,9958,2203,9166,7890,1276,188
2021,Ceredigion,W06000008,30891,21176,14798,6378,96,96,3239,752,2487,6371,5294,1077,9
2021,Pembrokeshire,W06000009,55487,37203,24647,12556,141,141,8994,5691,3303,9114,7277,1837,35
2021,Carmarthenshire,W06000010,81759,57565,35629,21936,209,209,11698,8540,3158,12171,10048,2123,116
2021,Swansea,W06000011,104962,65386,37162,28224,315,315,20045,12257,7788,18901,16417,2484,315
2021,Neath Port Talbot,W06000012,62377,41511,23850,17661,99,99,11999,4657,7342,8652,7014,1638,116
2021,Bridgend,W06000013,62360,43961,23670,20291,136,136,8674,2087,6587,9526,8128,1398,63
2021,Vale of Glamorgan,W06000014,57449,41283,22052,19231,135,135,7023,3660,3363,8977,7474,1503,31
2021,Cardiff,W06000015,147333,85427,42072,43355,439,439,25278,12883,12395,35785,32757,3028,404
2021,Rhondda Cynon Taff,W06000016,103339,70629,39686,30943,173,173,14175,5744,8431,18238,15671,2567,124
2021,Caerphilly,W06000018,76255,51502,27449,24053,228,228,14323,10065,4258,10154,8598,1556,48
2021,Blaenau Gwent,W06000019,30340,18222,10564,7658,36,36,7194,2776,4418,4847,4160,687,41
2021,Torfaen,W06000020,40241,25915,13952,11963,223,223,9575,3324,6251,4495,3701,794,33
2021,Monmouthshire,W06000021,40922,29429,17738,11691,147,147,5743,1493,4250,5582,4674,908,21
2021,Newport,W06000022,66054,41559,20172,21387,474,474,12864,5648,7216,11019,9663,1356,138
2021,Powys,W06000023,60182,40684,28098,12586,151,151,8481,5294,3187,10760,8592,2168,106
2021,Merthyr Tydfil,W06000024,25783,16113,9101,7012,33,33,5626,2168,3458,3967,3325,642,44
